loc,lloc,scloc,comments,single_comments,multi_comments,blanks,h1,h2,n1,n2,vocabulary,length,calculated_length,volume,difficulty,effort,time,bugs,LargeClass
469,247,371,10,17,28,53,11,104,67,109,115,176,734.8994785,1204.806249,5.764423077,6945.012945,385.8340525,0.401602083,1
141,84,93,1,1,16,31,2,4,3,4,6,7,10,18.09473751,1,18.09473751,1.005263195,0.006031579,1
473,259,290,51,51,73,59,13,92,56,105,105,161,648.2734163,1080.993528,7.418478261,8019.32699,445.5181661,0.360331176,1
1267,721,883,78,79,144,161,12,286,175,333,298,508,2376.742752,4175.337608,6.986013986,29168.96693,1620.498163,1.391779203,1
174,114,126,16,18,11,19,8,40,23,45,48,68,236.8771238,379.77745,4.5,1708.998525,94.94436251,0.126592483,1
495,244,299,46,45,88,63,9,94,56,103,103,159,644.6606771,1063.153584,4.930851064,5242.25198,291.2362211,0.354384528,1
149,80,116,14,14,8,11,9,31,18,33,40,51,182.1094106,271.4183328,4.790322581,1300.181369,72.23229826,0.090472778,1
59,27,37,0,1,11,10,1,2,1,2,3,3,2,4.754887502,0.5,2.377443751,0.132080208,0.001584963,1
238,137,190,13,13,10,25,7,45,24,45,52,69,266.7848738,393.3303406,3.5,1376.656192,76.48089955,0.131110114,1
135,89,108,6,6,4,17,4,17,10,18,21,28,77.4868683,122.9848878,2.117647059,260.438586,14.46881033,0.040994963,1
171,141,132,5,2,9,28,10,65,44,87,75,131,424.6731888,815.9752485,6.692307692,5460.757432,303.3754129,0.271991749,1
90,18,85,1,1,0,4,3,7,5,10,10,15,24.40637196,49.82892142,2.142857143,106.7762602,5.932014455,0.01660964,1
120,67,94,4,4,14,8,7,19,12,24,26,36,100.3621072,169.2158299,4.421052632,748.1120899,41.56178277,0.056405277,1
83,44,51,17,17,0,15,3,18,9,18,21,27,79.81353753,118.5925704,1.5,177.8888556,9.882714201,0.039530857,1
116,69,67,12,12,19,18,1,4,2,4,5,6,8,13.93156857,0.5,6.965784285,0.386988016,0.004643856,1
42,20,31,4,0,5,6,1,2,1,2,3,3,2,4.754887502,0.5,2.377443751,0.132080208,0.001584963,1
195,121,136,18,15,22,22,6,30,17,33,36,50,162.7164929,258.4962501,3.3,853.0376252,47.39097918,0.086165417,1
328,201,220,25,29,43,36,10,98,69,137,108,206,681.4608457,1391.506825,6.989795918,9726.348729,540.3527072,0.463835608,1
253,166,180,14,11,34,28,9,37,20,38,46,58,221.2790995,320.3665935,4.621621622,1480.613175,82.25628751,0.106788864,1
59,32,43,3,6,4,6,6,17,14,27,23,41,84.99664331,185.4660402,4.764705882,883.6911327,49.09395182,0.061822013,1
195,124,109,14,27,37,22,6,14,9,16,20,25,68.81274391,108.0482024,3.428571429,370.4509796,20.58060998,0.036016067,1
294,187,150,15,43,57,44,6,21,14,25,27,39,107.7484409,185.4406126,3.571428571,662.2879021,36.79377234,0.061813538,1
149,113,91,9,31,4,23,9,34,19,38,43,57,201.5030616,309.297091,5.029411765,1555.582428,86.42124602,0.10309903,1
649,388,315,44,85,155,94,8,42,29,44,50,73,250.4773318,412.0015019,4.19047619,1726.482484,95.91569355,0.137333834,1
317,215,189,14,37,33,58,18,91,59,108,109,167,667.2679623,1130.286782,10.68131868,12072.95332,670.719629,0.376762261,1
134,95,83,8,18,10,23,7,17,12,24,24,36,89.13835276,165.05865,4.941176471,815.5839178,45.31021765,0.05501955,1
581,310,333,104,107,71,70,15,109,65,124,124,189,796.3354503,1314.343103,8.532110092,11214.12005,623.0066695,0.438114368,1
305,190,174,14,15,65,51,10,49,29,51,59,80,308.3400633,470.6114439,5.204081633,2449.100372,136.0611318,0.156870481,1
246,99,96,77,79,11,60,2,5,2,5,7,7,13.60964047,19.65148445,1,19.65148445,1.091749136,0.006550495,1
654,344,442,92,93,78,41,10,228,147,287,238,434,1819.118204,3426.350909,6.293859649,21564.97173,1198.053985,1.14211697,1
59,45,43,8,10,0,6,5,12,6,12,17,18,54.62919048,73.57433114,2.5,183.9358279,10.2186571,0.024524777,1
279,95,235,17,16,14,14,6,17,13,25,23,38,84.99664331,171.8953543,4.411764706,758.3618573,42.1312143,0.057298451,1
149,102,107,19,16,5,21,6,47,25,49,53,74,276.575451,423.8661136,3.127659574,1325.708909,73.65049492,0.141288705,1
85,47,54,5,5,12,14,7,22,12,23,29,35,117.7589801,170.0293348,3.659090909,622.1527934,34.56404408,0.056676445,1
293,195,246,8,6,14,27,8,79,54,104,87,158,521.9986791,1017.985072,5.265822785,5360.528989,297.807166,0.339328357,1
47,36,35,1,1,9,2,3,8,3,8,11,11,28.7548875,38.05374781,1.5,57.08062171,3.17114565,0.012684583,1
279,95,235,17,16,14,14,6,17,13,25,23,38,84.99664331,171.8953543,4.411764706,758.3618573,42.1312143,0.057298451,1
64,45,47,4,4,6,7,4,13,6,13,17,19,56.10571634,77.66179398,2,155.323588,8.62908822,0.025887265,1
1817,1091,1318,182,211,184,104,6,91,53,101,97,154,607.7190873,1016.386578,3.32967033,3384.232231,188.0129017,0.338795526,1
368,111,277,13,13,52,26,7,73,50,96,80,146,471.5086773,923.0015019,4.602739726,4248.33568,236.0186489,0.307667167,1
222,107,106,1,1,79,36,6,26,15,28,32,43,137.7212077,215,3.230769231,694.6153846,38.58974359,0.071666667,1
290,166,204,58,58,0,28,8,100,67,122,108,189,688.385619,1276.673738,4.88,6230.167841,346.1204356,0.425557913,1
361,226,223,41,50,53,35,13,93,59,103,106,162,656.2474858,1089.923114,7.198924731,7846.274458,435.9041365,0.363307705,1
275,176,184,33,37,19,35,10,57,34,62,67,96,365.6940118,582.3445623,5.438596491,3167.137093,175.9520607,0.194114854,1
143,114,89,2,24,4,26,11,56,37,74,67,111,363.2656234,673.3359001,7.267857143,4893.709131,271.8727295,0.2244453,1
110,8,80,12,10,7,13,1,6,4,8,7,12,15.509775,33.68825906,0.666666667,22.45883938,1.247713299,0.01122942,1
308,99,252,29,29,0,27,2,16,8,16,18,24,66,100.0782,1,100.0782,5.559900002,0.0333594,1
37,33,33,0,0,0,4,1,2,1,2,3,3,2,4.754887502,0.5,2.377443751,0.132080208,0.001584963,1
1085,230,983,29,19,0,83,9,67,37,68,76,105,434.9573008,656.0323889,4.567164179,2996.207627,166.4559793,0.218677463,1
481,238,363,40,29,27,62,7,113,65,128,120,193,790.3317072,1333.029885,3.96460177,5284.932641,293.607369,0.444343295,1
509,180,340,12,12,115,42,1,12,6,12,13,18,43.01955001,66.60791493,0.5,33.30395746,1.850219859,0.022202638,1
219,186,184,8,8,0,27,2,4,3,5,6,8,10,20.67970001,1.25,25.84962501,1.436090278,0.006893233,1
305,237,218,37,48,0,39,5,13,9,14,18,23,59.71535681,95.90827503,2.692307692,258.2145866,14.34525481,0.031969425,1
819,575,540,150,156,0,123,12,43,34,58,55,92,276.3489345,531.8850936,8.093023256,4304.558432,239.1421351,0.177295031,1
345,210,259,8,6,32,48,2,14,7,14,16,21,55.30296891,84,1,84,4.666666667,0.028,1
197,113,108,0,0,67,22,1,2,1,2,3,3,2,4.754887502,0.5,2.377443751,0.132080208,0.001584963,1
415,83,322,5,5,68,20,5,13,8,16,18,24,59.71535681,100.0782,3.076923077,307.9329232,17.10738462,0.0333594,1
219,181,192,1,1,0,26,3,8,5,8,11,13,28.7548875,44.97261104,1.5,67.45891656,3.747717587,0.01499087,1
1256,615,988,124,73,11,184,2,28,19,38,30,57,136.6059378,279.6927639,1.357142857,379.5830368,21.08794649,0.093230921,1
470,209,311,54,54,45,60,2,2,2,3,4,5,4,10,1.5,15,0.833333333,0.003333333,1
502,325,337,56,56,58,51,2,10,5,10,12,15,35.21928095,53.77443751,1,53.77443751,2.987468751,0.017924813,1
191,220,149,3,3,0,39,1,2,2,2,3,4,2,6.339850003,0.5,3.169925001,0.176106945,0.002113283,1
536,395,401,42,37,9,89,15,170,132,246,185,378,1318.199818,2846.862192,10.85294118,30896.82791,1716.490439,0.948954064,1
681,367,370,64,49,152,110,15,167,103,191,182,294,1291.681976,2207.291624,8.577844311,18933.8039,1051.877995,0.735763875,1
643,592,552,19,19,0,72,4,107,71,129,111,200,729.3369675,1358.883173,2.411214953,3276.559427,182.0310793,0.452961058,1
510,388,395,33,33,0,82,5,80,62,116,85,178,517.3638881,1140.871587,3.625,4135.659502,229.7588612,0.380290529,1
530,404,397,48,48,0,85,5,51,30,58,56,88,300.9033329,511.0472331,2.843137255,1452.977428,80.7209682,0.170349078,1
449,362,351,29,28,0,70,4,63,33,65,67,98,384.5686352,594.4767407,2.063492063,1226.698036,68.14989091,0.198158914,1
78,14,72,7,0,0,6,5,30,146,284,35,430,158.8163583,2205.591697,23.66666667,52199.0035,2899.944639,0.735197232,1
43,9,36,6,1,0,6,5,24,22,35,29,57,121.6487405,276.9049167,3.645833333,1009.549176,56.08606531,0.092301639,1
43,9,36,6,1,0,6,5,33,29,48,38,77,178.0746464,404.0904185,3.636363636,1469.419704,81.63442799,0.134696806,1
53,14,48,9,0,0,5,3,16,31,50,19,81,68.7548875,344.0821286,4.6875,1612.884978,89.60472099,0.114694043,1
49,20,40,4,4,0,5,2,5,12,14,7,26,13.60964047,72.99122797,2.8,204.3754383,11.35419102,0.024330409,1
4469,2363,4049,14,15,0,405,12,251,395,516,263,911,2043.876982,7323.455199,12.33466135,90332.33983,5018.463324,2.441151733,1
475,199,235,25,25,143,72,16,152,93,185,168,278,1165.684982,2055.064244,9.736842105,20009.83606,1111.657559,0.685021415,1
290,152,198,27,35,20,37,7,90,100,141,97,241,603.9182631,1590.578995,5.483333333,8721.674822,484.5374901,0.530192998,1
292,158,221,6,5,5,61,5,285,184,315,290,499,2335.732802,4081.774636,2.763157895,11278.58781,626.5882117,1.360591545,1
353,174,258,39,39,0,56,7,29,26,35,36,61,160.5329333,315.3654251,4.224137931,1332.147054,74.00816968,0.105121808,1
220,124,107,1,11,62,40,2,6,4,8,8,12,17.509775,36,1.333333333,48,2.666666667,0.012,1
134,106,111,0,0,0,23,1,4,4,4,5,8,8,18.57542476,0.5,9.28771238,0.515984021,0.006191808,1
335,271,266,22,22,0,47,4,35,52,57,39,109,187.5249056,576.1088419,3.257142857,1876.468799,104.2482666,0.192036281,1
242,203,213,0,0,0,29,4,35,27,54,39,81,187.5249056,428.1175797,3.085714286,1321.048532,73.3915851,0.14270586,1
286,234,246,0,0,0,40,4,35,27,54,39,81,187.5249056,428.1175797,3.085714286,1321.048532,73.3915851,0.14270586,1
809,482,479,64,58,125,147,19,210,164,319,229,483,1700.702181,3786.33543,14.43095238,54640.42628,3035.579238,1.26211181,1
575,280,315,44,40,99,121,19,171,131,247,190,378,1349.163403,2861.40542,13.72222222,39264.84104,2181.380058,0.953801807,1
1128,701,742,126,120,85,181,20,286,215,403,306,618,2420.161764,5103.065687,14.09090909,71906.83468,3994.824149,1.701021896,1
462,306,302,36,35,58,67,16,181,123,244,197,367,1421.472106,2797.293018,10.78453039,30167.49155,1675.971753,0.932431006,1
382,224,226,25,24,68,64,16,87,49,100,103,149,624.5360841,996.2885786,9.195402299,9161.274286,508.9596825,0.332096193,1
386,141,135,2,4,158,89,11,60,39,72,71,111,392.4671835,682.6219303,6.6,4505.30474,250.2947078,0.227540643,1
420,180,313,79,79,0,28,6,137,122,193,143,315,987.9401704,2255.359471,4.226277372,9531.774699,529.5430388,0.75178649,1
1569,1166,1178,164,155,0,236,18,343,583,1047,361,1630,2963.826865,13848.24369,27.47230321,380443.1496,21135.73054,4.616081231,1
382,263,297,14,17,0,68,8,41,51,65,49,116,243.6596322,651.3063419,6.341463415,4130.235339,229.4575188,0.217102114,1
278,231,233,7,7,0,38,6,114,65,127,120,192,794.4592366,1326.122994,3.342105263,4432.042639,246.2245911,0.442040998,1
748,593,633,21,21,0,94,5,100,77,151,105,228,675.9952595,1530.847978,3.775,5778.951117,321.0528398,0.510282659,1
832,552,603,27,20,0,209,8,192,169,272,200,441,1480.3128,3370.94058,5.666666667,19101.99662,1061.222034,1.12364686,1
559,393,455,9,12,0,92,15,297,313,513,312,826,2498.256138,6843.742233,12.95454545,88657.56983,4925.420546,2.281247411,1
993,539,775,73,73,0,145,12,255,218,332,267,550,2081.579676,4433.382762,7.811764706,34632.54299,1924.030166,1.477794254,1
625,297,290,44,42,199,94,20,188,139,270,208,409,1506.701266,3149.479845,14.36170213,45231.89139,2512.882855,1.049826615,1
1069,452,443,42,37,437,152,22,407,302,569,429,871,3626.343684,7616.750272,15.37837838,117133.2677,6507.403761,2.538916757,1
263,197,192,1,1,0,70,1,6,3,6,7,9,15.509775,25.2661943,0.5,12.63309715,0.701838731,0.008422065,1
365,265,274,13,14,16,61,9,47,34,59,56,93,289.595001,540.0840078,5.64893617,3050.900086,169.4944492,0.180028003,1
265,162,202,17,11,15,37,2,11,8,13,13,21,40.05374781,77.70923408,1.181818182,91.83818573,5.10212143,0.025903078,1
135,27,112,9,9,0,14,5,8,12,24,13,36,35.60964047,133.2158299,7.5,999.1187239,55.50659577,0.044405277,1
463,339,239,8,109,0,115,6,16,11,21,22,32,79.509775,142.7018118,3.9375,561.8883839,31.21602133,0.047567271,1
710,419,454,171,169,0,87,15,225,149,280,240,429,1816.704127,3392.056066,9.333333333,31659.18994,1758.843886,1.130685355,1
194,133,132,36,35,0,27,13,50,62,117,63,179,330.2985258,1069.933106,15.21,16273.68255,904.0934748,0.356644369,1
191,146,144,5,5,0,42,7,44,22,44,51,66,259.8664757,374.3800726,3.5,1310.330254,72.79612522,0.124793358,1
446,178,188,101,101,93,64,10,114,89,165,124,254,812.1687426,1766.365863,7.236842105,12782.91085,710.1617139,0.588788621,1
807,376,322,26,35,299,151,8,88,47,91,96,138,592.4299824,908.7248251,4.136363636,3758.816322,208.823129,0.302908275,1
570,225,224,4,3,239,104,13,79,58,112,92,170,546.1043954,1109.005533,9.215189873,10219.69655,567.7609196,0.369668511,1
386,184,152,4,4,164,66,6,30,16,32,36,48,162.7164929,248.1564001,3.2,794.1004802,44.11669335,0.0827188,1
805,337,339,48,46,288,132,17,73,44,85,90,129,521.3440611,837.4490494,9.897260274,8288.451208,460.4695116,0.279149683,1
665,379,393,27,29,138,105,14,100,62,118,114,180,717.6885879,1229.920203,8.26,10159.14087,564.3967152,0.409973401,1
636,433,440,30,30,108,58,15,215,173,307,230,480,1724.464822,3765.835224,10.70930233,40329.46793,2240.525996,1.255278408,1
108,63,63,5,1,32,12,9,40,37,70,49,107,241.4064488,600.7739533,7.875,4731.094882,262.8386046,0.200257984,1
1431,552,560,79,80,485,306,14,146,82,155,160,237,1103.017355,1735.296958,7.431506849,12895.87123,716.4372907,0.578432319,1
133,50,103,0,0,10,20,5,34,19,38,39,57,184.5833771,301.2679265,2.794117647,841.7780299,46.7654461,0.100422642,1
337,158,159,5,4,128,46,12,76,42,87,88,129,517.862041,833.2666788,6.868421053,5723.226399,317.9570222,0.27775556,1
500,278,292,39,40,83,85,17,149,109,213,166,322,1145.142978,2374.762697,12.15100671,28855.75747,1603.097637,0.791587566,1
1132,662,641,35,51,235,205,19,262,147,283,281,430,2185.467449,3497.803318,10.26145038,35892.53519,1994.029733,1.165934439,1
690,471,528,23,23,24,115,11,146,155,242,157,397,1087.768133,2895.964437,9.116438356,26400.88127,1466.715626,0.965321479,1
113,39,93,5,3,5,12,6,21,12,24,27,36,107.7484409,171.1759501,3.428571429,586.8889717,32.60494287,0.05705865,1
889,512,697,56,39,27,126,18,398,277,545,416,822,3512.435249,7151.761448,12.3241206,88139.17061,4896.62059,2.383920483,1
441,237,218,13,19,126,78,9,60,32,61,69,93,382.9427607,568.0927745,4.575,2599.024443,144.3902468,0.189364258,1
906,418,434,22,17,305,150,16,205,203,357,221,560,1638.29342,4361.225433,13.93170732,60759.31628,3375.517571,1.453741811,1
307,186,199,34,28,22,58,14,87,67,131,101,198,613.839053,1318.325874,10.54022989,13895.45777,771.9698762,0.439441958,1
589,348,426,38,41,52,70,13,169,100,185,182,285,1298.854341,2139.721472,7.115384615,15224.94125,845.8300692,0.713240491,1
917,504,462,40,70,206,179,17,155,104,200,172,304,1197.286151,2257.584485,10.96774194,24760.60403,1375.589113,0.752528162,1
522,273,307,4,4,137,74,14,206,139,273,220,412,1636.722078,3205.920202,9.276699029,29740.35683,1652.242046,1.068640067,1
276,143,130,3,6,85,55,7,39,21,40,46,61,225.782171,336.9372793,3.58974359,1209.518439,67.19546881,0.112312426,1
399,125,108,22,23,178,90,12,47,34,60,59,94,304.085226,552.9684466,7.659574468,4235.502996,235.305722,0.184322816,1
126,80,83,5,5,14,24,7,39,29,53,46,82,225.782171,452.9320804,4.756410256,2154.330793,119.685044,0.15097736,1
7112,2401,2624,291,264,2695,1529,23,1169,958,1783,1192,2741,12017.39015,28010.74091,17.5402053,491314.1463,27295.23035,9.336913638,1
3033,1426,1457,140,154,869,553,20,650,431,834,670,1265,6160.230902,11875.84187,12.83076923,152376.1864,8465.343689,3.958613955,1
353,212,203,34,30,58,62,12,95,56,112,107,168,667.1558328,1132.566454,7.073684211,8011.417441,445.0787467,0.377522151,1
242,151,174,14,13,2,53,13,76,43,80,89,123,522.9482074,796.515212,6.842105263,5449.840924,302.7689402,0.265505071,1
286,158,185,31,25,11,65,13,88,54,110,101,164,616.5356988,1091.946683,8.125,8872.066801,492.8926,0.363982228,1
385,227,278,36,25,26,56,16,89,51,98,105,149,640.3402754,1000.422582,8.808988764,8812.711285,489.5950714,0.333474194,1
259,153,203,19,11,11,34,13,71,39,77,84,116,484.7377618,741.508821,7.049295775,5227.114999,290.3952777,0.247169607,1
1081,680,847,115,105,9,120,20,257,163,316,277,479,2143.884071,3886.482498,12.29571984,47787.09997,2654.838887,1.295494166,1
620,399,469,58,59,11,81,17,234,159,304,251,463,1911.152213,3690.824665,11.04273504,40756.79887,2264.266604,1.230274888,1
205,136,145,7,6,28,26,10,73,43,83,83,126,485.0764737,803.2549683,5.684931507,4566.449478,253.6916376,0.267751656,1
765,510,580,21,20,56,109,19,279,166,329,298,495,2347.340469,4068.488418,11.20250896,45577.27795,2532.070997,1.356162806,1
923,613,732,41,38,25,128,15,311,213,393,326,606,2633.923068,5059.329261,9.477491961,47949.75241,2663.875134,1.686443087,1
364,173,228,65,67,21,48,14,71,43,85,85,128,489.9350144,820.4020398,8.38028169,6875.200193,381.9555663,0.273467347,1
172,111,103,8,8,39,22,6,21,16,32,27,48,107.7484409,228.2346001,4.571428571,1043.358172,57.96434288,0.0760782,1
228,123,148,11,12,27,41,10,78,59,106,88,165,523.480654,1065.806217,6.794871795,7242.016603,402.3342557,0.355268739,1
584,233,253,119,120,97,114,16,117,75,146,133,221,867.8326722,1559.217418,9.982905983,15565.52089,864.7511607,0.519739139,1
271,87,86,22,27,97,61,11,37,22,43,48,65,230.8035223,363.0225625,6.391891892,2320.400974,128.9111652,0.121007521,1
648,427,564,0,0,0,84,5,148,142,280,153,422,1078.608739,3062.61767,4.72972973,14485.35384,804.7418802,1.020872557,1
929,474,789,39,39,4,97,14,139,113,220,153,333,1042.835778,2416.710152,11.07913669,26775.06211,1487.503451,0.805570051,1
414,173,218,40,39,119,38,6,125,209,359,131,568,886.2328106,3994.984265,8.616,34420.78443,1912.265801,1.331661422,1
700,306,350,56,55,77,218,15,119,72,136,134,208,879.0866728,1469.746552,8.571428571,12597.82759,699.8793103,0.489915517,1
1119,579,620,52,55,231,213,16,290,191,370,306,561,2436.173636,4632.39458,10.20689655,47282.37226,2626.798459,1.544131527,1
808,191,144,9,9,491,164,7,19,11,20,26,31,100.3621072,145.7136313,3.684210526,536.8396941,29.82442745,0.04857121,1
1756,873,1354,231,222,0,180,12,398,402,723,410,1125,3480.396149,9764.415112,10.89949749,106427.218,5912.623221,3.254805037,1
1083,864,862,104,103,0,118,12,161,185,300,173,485,1223.297167,3605.79469,11.18012422,40313.23256,2239.624031,1.201931563,1
51,39,40,1,1,0,10,5,20,13,21,25,34,98.04820237,157.8911105,2.625,414.4641649,23.02578694,0.05263037,1
256,195,203,9,8,3,42,10,47,35,58,57,93,294.284957,542.4587713,6.170212766,3347.086036,185.9492242,0.18081959,1
149,109,119,17,17,0,13,5,17,9,17,22,26,81.09650878,115.9452221,2.5,289.8630552,16.10350307,0.038648407,1
430,340,338,44,44,0,48,6,75,58,80,81,138,482.6711768,874.8993004,3.2,2799.677761,155.5376534,0.2916331,1
206,171,149,2,29,0,28,15,59,41,79,74,120,405.6792988,745.1344039,10.04237288,7482.91753,415.7176406,0.248378135,1
1140,750,767,106,107,119,147,19,197,208,362,216,570,1582.254831,4420.285876,17.45685279,77164.27984,4286.904436,1.473428625,1
196,117,137,6,5,0,54,8,129,66,131,137,197,928.4483159,1398.31232,4.062015504,5679.966324,315.5536847,0.466104107,1
58,82,50,0,0,0,8,4,20,10,20,24,30,94.4385619,137.548875,2,275.09775,15.28320834,0.045849625,1
181,118,133,10,10,0,38,8,162,81,169,170,250,1213.0557,1852.347734,4.172839506,7729.549804,429.4194335,0.617449245,1
1362,706,737,22,19,430,176,17,267,165,304,284,469,2221.692682,3822.231399,9.677902622,36991.18328,2055.065738,1.274077133,1
697,536,588,32,24,0,85,12,248,158,286,260,444,2015.660235,3561.931309,6.919354839,24646.26664,1369.237035,1.187310436,1
65,47,56,1,0,0,9,4,12,7,12,16,19,51.01955001,76,2,152,8.444444444,0.025333333,1
195,122,131,42,43,0,21,9,57,34,63,66,97,361.0040558,586.3062296,4.973684211,2916.102037,162.0056687,0.19543541,1
45,24,38,0,0,0,7,2,5,3,6,7,9,13.60964047,25.2661943,1.2,30.31943316,1.684412953,0.008422065,1
641,401,442,53,61,50,88,11,174,103,193,185,296,1333.125916,2229.288912,6.100574713,13599.94357,755.5524203,0.743096304,1
336,186,182,1,1,85,68,14,78,55,105,92,160,543.564342,1043.769913,9.423076923,9835.52418,546.41801,0.347923304,1
239,168,168,2,2,0,69,5,24,13,25,29,38,121.6487405,184.6032778,2.604166667,480.7377026,26.70765015,0.061534426,1
309,253,264,5,6,0,39,4,28,22,39,32,61,142.6059378,305,2.785714286,849.6428571,47.20238095,0.101666667,1
247,166,176,31,32,0,39,9,39,24,44,48,68,234.6600115,379.77745,5.076923077,1928.1009,107.1167167,0.126592483,1
454,220,225,82,82,115,32,13,81,53,97,94,150,561.6335666,983.1883278,7.783950617,7653.089391,425.1716328,0.327729443,1
615,485,486,80,79,0,50,11,95,82,137,106,219,662.1900306,1473.41458,7.931578947,11686.50406,649.2502255,0.491138193,1
532,420,430,65,65,0,37,10,138,173,316,148,489,1014.195656,3525.422696,11.44927536,40363.53521,2242.418623,1.175140899,1
278,212,214,43,43,0,21,9,87,92,171,96,263,589.0654092,1731.845138,8.844827586,15317.87165,850.9928694,0.577281713,1
648,445,523,90,90,0,35,12,63,59,91,75,150,419.5881852,934.3228036,8.666666667,8097.464298,449.8591276,0.311440935,1
506,388,409,66,66,0,31,9,79,121,177,88,298,526.5280041,1924.910622,10.08227848,19407.48495,1078.193608,0.641636874,1
794,196,172,8,8,477,137,10,48,36,68,58,104,301.297481,609.2300235,7.083333333,4315.379333,239.7432963,0.203076674,1
944,355,334,18,18,412,180,16,122,74,141,138,215,909.5499552,1528.332758,9.245901639,14130.81435,785.0452419,0.509444253,1
530,344,443,21,21,0,66,11,62,55,72,73,127,407.213919,786.107719,6.387096774,5020.946076,278.9414487,0.262035906,1
222,166,139,27,54,0,29,2,60,30,60,62,90,356.4134357,535.8776679,1,535.8776679,29.77098155,0.178625889,1
237,173,151,29,56,0,30,8,159,96,190,167,286,1186.74839,2111.739428,4.779874214,10093.84884,560.7693798,0.703913143,1
251,168,168,27,54,0,29,4,64,33,64,68,97,392,590.4838956,2,1180.967791,65.60932173,0.196827965,1
241,177,146,31,62,0,33,2,72,36,72,74,108,446.2346001,670.6209635,1,670.6209635,37.25672019,0.223540321,1
448,254,271,49,49,73,55,13,92,56,105,105,161,648.2734163,1080.993528,7.418478261,8019.32699,445.5181661,0.360331176,1
242,109,174,40,40,4,24,8,31,16,32,39,48,177.5800856,253.6993065,4.129032258,1047.53262,58.19625669,0.084566436,1
827,451,577,65,60,110,80,14,166,103,191,180,294,1277.559515,2202.60481,8.054216867,17740.25682,985.5698231,0.734201603,1
1349,1013,1063,74,72,41,173,4,38,27,40,42,67,207.4212455,361.2852673,2.105263158,760.6005628,42.25558682,0.120428422,1
1817,1091,1318,182,211,184,104,6,91,53,101,97,154,607.7190873,1016.386578,3.32967033,3384.232231,188.0129017,0.338795526,1
1132,662,641,35,51,235,205,19,262,147,283,281,430,2185.467449,3497.803318,10.26145038,35892.53519,1994.029733,1.165934439,1
690,471,528,23,23,24,115,11,146,155,242,157,397,1087.768133,2895.964437,9.116438356,26400.88127,1466.715626,0.965321479,1
889,512,697,56,39,27,126,18,398,277,545,416,822,3512.435249,7151.761448,12.3241206,88139.17061,4896.62059,2.383920483,1
870,502,462,40,70,163,175,17,155,104,200,172,304,1197.286151,2257.584485,10.96774194,24760.60403,1375.589113,0.752528162,1
522,273,307,4,4,137,74,14,206,139,273,220,412,1636.722078,3205.920202,9.276699029,29740.35683,1652.242046,1.068640067,1
7112,2401,2624,291,264,2695,1529,23,1169,958,1783,1192,2741,12017.39015,28010.74091,17.5402053,491314.1463,27295.23035,9.336913638,1
27,18,18,3,3,0,6,1,4,2,4,5,6,8,13.93156857,0.5,6.965784285,0.386988016,0.004643856,0
70,51,49,11,11,0,10,5,14,9,16,19,25,64.91260938,106.1981878,2.857142857,303.4233938,16.85685521,0.035399396,0
77,52,54,13,13,0,10,6,42,32,59,48,91,241.9871068,508.2315876,4.214285714,2141.833119,118.9907288,0.169410529,0
71,49,51,11,11,0,9,6,35,26,48,41,74,195.0346806,396.4588483,4.114285714,1631.144976,90.61916534,0.132152949,0
26,15,16,5,5,0,5,3,5,3,6,8,9,16.36452798,27,1.8,48.6,2.7,0.009,0
35,22,25,4,4,0,6,1,2,1,2,3,3,2,4.754887502,0.5,2.377443751,0.132080208,0.001584963,0
52,36,38,8,8,0,6,4,27,20,40,31,60,136.3819626,297.2517786,2.962962963,880.7460107,48.93033393,0.099083926,0
62,45,45,6,6,0,11,1,1,1,1,2,2,0,2,0.5,1,0.055555556,0.000666667,0
40,20,36,0,0,0,4,1,2,2,2,3,4,2,6.339850003,0.5,3.169925001,0.176106945,0.002113283,0
74,54,51,9,9,0,14,1,3,2,4,4,6,4.754887502,12,0.666666667,8,0.444444444,0.004,0
89,68,64,8,6,0,19,4,16,11,18,20,29,72,125.3359148,2.25,282.0058082,15.66698934,0.041778638,0
55,45,47,0,0,0,8,3,9,7,13,12,20,33.28421252,71.69925001,2.166666667,155.348375,8.63046528,0.02389975,0
82,68,68,1,1,0,13,5,21,14,25,26,39,103.8483064,183.317149,2.976190476,545.586753,30.31037517,0.061105716,0
32,27,27,0,0,0,5,5,7,8,14,12,22,31.26112493,78.86917502,5,394.3458751,21.90810417,0.026289725,0
67,54,56,1,1,0,10,8,28,36,69,36,105,158.6059378,542.8421252,9.857142857,5350.872376,297.2706876,0.180947375,0
18,12,11,2,3,0,4,1,3,5,5,4,10,4.754887502,20,0.833333333,16.66666667,0.925925926,0.006666667,0
33,25,25,0,0,0,8,4,14,8,15,18,23,61.30296891,95.90827503,2.142857143,205.5177322,11.41765179,0.031969425,0
156,137,129,28,12,0,15,1,10,67,67,11,134,33.21928095,463.5638369,3.35,1552.938854,86.27438076,0.154521279,0
28,22,22,0,0,0,6,3,5,3,5,8,8,16.36452798,24,1.5,36,2,0.008,0
36,23,26,2,2,0,8,4,10,6,12,14,18,41.21928095,68.5323886,2.4,164.4777326,9.137651813,0.02284413,0
126,92,106,1,2,0,18,15,58,32,63,73,95,398.3662567,588.0333331,8.146551724,4790.443964,266.1357758,0.196011111,0
18,14,14,0,0,0,4,1,5,18,18,6,36,11.60964047,93.05865003,1.8,167.50557,9.305865003,0.03101955,0
11,8,8,0,0,0,3,2,14,15,21,16,36,55.30296891,144,1.5,216,12,0.048,0
109,92,96,2,2,0,11,6,169,147,273,175,420,1266.2584,3129.508667,4.846153846,15166.08046,842.5600257,1.043169556,0
34,27,29,0,0,0,5,3,15,9,18,18,27,63.35824644,112.587975,1.8,202.6583551,11.2587975,0.037529325,0
15,10,12,0,0,0,3,2,7,5,10,9,15,21.65148445,47.54887502,1.428571429,67.92696432,3.77372024,0.015849625,0
42,34,35,1,1,0,6,5,27,16,31,32,47,139.991603,235,2.87037037,674.537037,37.47427984,0.078333333,0
22,17,18,0,0,0,4,3,18,11,22,21,33,79.81353753,144.946475,1.833333333,265.7352041,14.76306689,0.048315492,0
17,13,14,0,0,0,3,4,14,15,29,18,44,61.30296891,183.4767001,4.142857143,760.1177574,42.2287643,0.0611589,0
61,48,47,0,1,0,13,3,10,6,12,13,18,37.97416845,66.60791493,1.8,119.8942469,6.660791493,0.022202638,0
32,25,25,0,0,0,7,1,18,12,24,19,36,75.05865003,152.9253905,0.666666667,101.9502603,5.663903351,0.05097513,0
34,23,25,4,4,0,5,2,6,3,6,8,9,17.509775,27,1,27,1.5,0.009,0
23,15,16,4,4,0,3,5,12,9,18,17,27,54.62919048,110.3614967,3.75,413.8556127,22.99197848,0.036787166,0
19,11,12,7,4,0,3,2,6,3,6,8,9,17.509775,27,1,27,1.5,0.009,0
23,15,16,4,4,0,3,5,12,9,18,17,27,54.62919048,110.3614967,3.75,413.8556127,22.99197848,0.036787166,0
66,47,53,0,1,0,12,10,32,19,34,42,53,193.2192809,285.7928234,5.3125,1518.274374,84.34857635,0.095264274,0
336,70,65,4,8,204,59,8,20,11,20,28,31,110.4385619,149.0280026,4,596.1120103,33.11733391,0.049676001,0
32,20,22,2,1,0,9,3,9,5,10,12,15,33.28421252,53.77443751,1.666666667,89.62406252,4.979114584,0.017924813,0
104,79,77,5,5,0,22,2,6,13,24,8,37,17.509775,111,4,444,24.66666667,0.037,0
40,29,29,4,4,0,7,1,1,1,1,2,2,0,2,0.5,1,0.055555556,0.000666667,0
62,48,48,3,3,0,11,6,21,17,26,27,43,107.7484409,204.4601626,3.714285714,759.4234611,42.19019228,0.068153388,0
64,24,38,10,10,0,16,1,6,6,6,7,12,15.509775,33.68825906,0.5,16.84412953,0.935784974,0.01122942,0
40,33,33,3,3,0,4,4,10,6,12,14,18,41.21928095,68.5323886,2.4,164.4777326,9.137651813,0.02284413,0
117,92,89,12,9,0,19,7,78,58,112,85,170,509.9128575,1089.596459,5.025641026,5475.920666,304.2178148,0.36319882,0
224,77,75,15,15,100,34,9,37,28,47,46,75,221.2790995,414.2671467,5.716216216,2368.040582,131.5578101,0.138089049,0
135,66,57,0,0,51,27,8,66,52,104,74,156,422.9300119,968.674725,6.303030303,6105.586146,339.1992303,0.322891575,0
176,100,98,5,5,44,29,14,67,43,80,81,123,459.7309447,779.8015504,8.358208955,6517.744301,362.0969056,0.25993385,0
193,162,171,8,2,4,16,11,169,112,217,180,329,1288.802373,2464.819669,7.062130178,17406.87736,967.0487425,0.821606556,0
38,26,27,5,5,0,6,1,1,1,1,2,2,0,2,0.5,1,0.055555556,0.000666667,0
70,44,44,13,11,0,15,10,15,11,21,25,32,91.82263988,148.6033981,7,1040.223787,57.79021036,0.049534466,0
135,99,108,8,8,0,19,6,30,33,53,36,86,162.7164929,444.6135501,5.3,2356.451816,130.9139898,0.148204517,0
72,55,59,6,3,0,10,5,54,54,99,59,153,322.3735656,900.0443866,4.583333333,4125.203438,229.1779688,0.300014796,0
64,50,50,5,4,0,10,3,29,35,48,32,83,145.6363364,415,2.482758621,1030.344828,57.24137931,0.138333333,0
29,23,22,3,3,0,4,3,15,13,26,18,39,63.35824644,162.6270751,2.6,422.8303951,23.49057751,0.054209025,0
19,12,15,0,0,0,4,1,5,15,30,6,45,11.60964047,116.3233125,3,348.9699376,19.38721876,0.038774438,0
56,46,48,0,0,0,8,2,25,28,32,27,60,118.0964047,285.2932501,1.28,365.1753602,20.28752001,0.09509775,0
66,41,55,0,0,0,11,2,20,18,36,22,54,88.4385619,240.8093074,1.8,433.4567533,24.08093074,0.080269769,0
56,39,44,0,1,0,11,3,6,3,6,9,9,20.26466251,28.52932501,1.5,42.79398752,2.377443751,0.009509775,0
154,89,102,18,18,0,34,7,57,54,84,64,138,352.1262153,828,5.157894737,4270.736842,237.2631579,0.276,0
36,20,24,4,4,0,8,4,17,12,23,21,35,77.4868683,153.7311098,2.705882353,415.9782971,23.10990539,0.051243703,0
146,85,115,9,8,0,23,9,62,57,102,71,159,397.6894963,977.809792,7.403225806,7238.946686,402.1637048,0.325936597,0
81,74,61,2,2,0,18,9,40,28,50,49,78,241.4064488,437.9473678,5.625,2463.453944,136.8585525,0.145982456,0
250,161,177,32,32,0,41,7,20,26,34,27,60,106.0900464,285.2932501,5.95,1697.494838,94.30526879,0.09509775,0
147,108,105,14,11,0,31,9,49,49,85,58,134,303.6501074,784.9694533,7.806122449,6127.567672,340.4204262,0.261656484,0
58,47,48,0,0,0,10,8,21,12,24,29,36,116.2386659,174.8873158,4.571428571,799.4848723,44.41582624,0.058295772,0
135,96,107,1,1,0,27,5,27,30,39,32,69,139.991603,345,3.611111111,1245.833333,69.21296296,0.115,0
9,9,8,0,1,0,0,1,2,1,2,3,3,2,4.754887502,0.5,2.377443751,0.132080208,0.001584963,0
252,163,176,7,9,27,40,13,103,68,121,116,189,736.8152706,1296.158408,7.63592233,9897.364932,549.8536073,0.432052803,0
61,37,51,1,2,0,8,5,20,12,23,25,35,98.04820237,162.5349666,2.875,467.2880291,25.96044606,0.054178322,0
47,27,26,2,2,9,10,1,2,1,2,3,3,2,4.754887502,0.5,2.377443751,0.132080208,0.001584963,0
60,33,32,0,0,19,9,4,32,20,40,36,60,168,310.1955001,2.5,775.4887502,43.08270835,0.1033985,0
73,38,36,5,5,23,9,5,44,28,56,49,84,251.8246317,471.6356269,3.181818182,1500.658813,83.36993405,0.157211876,0
13,9,9,0,0,0,4,1,2,1,2,3,3,2,4.754887502,0.5,2.377443751,0.132080208,0.001584963,0
27,21,22,0,0,0,5,3,6,3,6,9,9,20.26466251,28.52932501,1.5,42.79398752,2.377443751,0.009509775,0
16,11,12,0,0,0,4,1,1,1,1,2,2,0,2,0.5,1,0.055555556,0.000666667,0
205,114,116,9,5,60,24,14,55,38,73,69,111,371.2777532,678.0462147,9.290909091,6299.66574,349.98143,0.226015405,0
121,68,60,5,6,39,16,10,32,21,39,42,60,193.2192809,323.5390454,6.09375,1971.566058,109.5314477,0.107846348,0
138,90,96,5,3,27,12,7,33,26,43,40,69,186.1164904,367.2130385,4.560606061,1674.714009,93.03966717,0.122404346,0
224,108,125,13,15,57,27,12,39,26,47,51,73,249.1502365,414.08705,7.230769231,2994.1679,166.3426611,0.138029017,0
303,183,199,54,47,34,23,15,78,43,86,93,129,548.864732,843.5514866,8.269230769,6975.521909,387.5289949,0.281183829,0
61,33,37,1,3,12,9,3,5,3,5,8,8,16.36452798,24,1.5,36,2,0.008,0
86,68,68,0,0,0,18,6,20,21,38,26,59,101.9483369,277.3259434,5.7,1580.757877,87.81988207,0.092441981,0
12,10,9,0,0,0,3,1,2,1,2,3,3,2,4.754887502,0.5,2.377443751,0.132080208,0.001584963,0
61,43,43,1,1,0,17,2,9,7,9,11,16,30.52932501,55.3509059,1,55.3509059,3.075050328,0.018450302,0
16,11,11,1,1,0,4,3,7,4,7,10,11,24.40637196,36.54120904,1.5,54.81181357,3.045100754,0.012180403,0
103,69,82,6,6,0,15,3,25,20,37,28,57,120.8512922,274.0192306,2.22,608.3226918,33.7957051,0.091339744,0
10,6,6,1,1,0,3,2,4,3,6,6,9,10,23.26466251,1.5,34.89699376,1.938721876,0.007754888,0
52,41,41,1,1,0,10,1,32,16,32,33,48,160,242.1309177,0.5,121.0654589,6.725858826,0.080710306,0
70,49,51,7,7,0,12,2,24,14,28,26,42,112.0391,197.4184682,1.166666667,230.3215462,12.79564145,0.065806156,0
34,25,24,0,0,3,7,4,17,9,18,21,27,77.4868683,118.5925704,2.117647059,251.1372079,13.95206711,0.039530857,0
116,59,106,1,1,0,9,2,20,33,37,22,70,88.4385619,312.1602133,1.85,577.4963946,32.08313303,0.104053404,0
15,12,12,0,0,0,3,4,8,7,12,12,19,32,68.11428751,3,204.3428625,11.35238125,0.022704763,0
116,103,103,1,1,0,12,5,97,75,128,102,203,651.8011862,1354.502344,3.298969072,4468.461342,248.2478524,0.451500781,0
243,192,199,5,5,0,39,7,102,99,156,109,255,700.2388693,1725.887003,5.352941176,9238.571603,513.253978,0.575295668,0
17,14,14,0,0,0,3,4,16,16,24,20,40,72,172.8771238,3,518.6313714,28.81285397,0.057625708,0
44,27,29,2,2,4,9,3,6,5,7,9,12,20.26466251,38.03910002,1.75,66.56842503,3.698245835,0.0126797,0
38,22,29,2,2,0,7,3,6,5,7,9,12,20.26466251,38.03910002,1.75,66.56842503,3.698245835,0.0126797,0
39,28,28,2,3,0,8,2,8,8,10,10,18,26,59.79470571,1.25,74.74338213,4.152410119,0.019931569,0
44,29,34,6,4,0,6,4,23,17,26,27,43,112.041925,204.4601626,2.260869565,462.2577589,25.68098661,0.068153388,0
30,22,22,0,0,0,8,4,9,5,9,13,14,36.52932501,51.80615605,2,103.6123121,5.756239562,0.017268719,0
43,32,29,0,0,0,14,1,1,1,1,2,2,0,2,0.5,1,0.055555556,0.000666667,0
73,54,47,0,0,3,23,3,51,34,54,54,88,294.0485799,506.4301002,1.588235294,804.3301591,44.68500884,0.168810033,0
31,23,25,0,0,0,6,3,30,21,42,33,63,151.9616054,317.7968295,2.1,667.373342,37.07629678,0.105932277,0
148,129,122,5,8,0,18,7,89,64,114,96,178,595.9917598,1172.123325,4.483146067,5254.800076,291.9333375,0.390707775,0
272,195,179,28,25,22,46,4,129,150,277,133,427,912.4483159,3012.6056,4.294573643,12937.85661,718.7698115,1.004201867,0
77,49,47,8,10,0,20,2,6,4,8,8,12,17.509775,36,1.333333333,48,2.666666667,0.012,0
108,94,94,3,3,0,11,2,4,2,4,6,6,10,15.509775,1,15.509775,0.861654167,0.005169925,0
57,50,50,0,0,0,7,2,19,11,22,21,33,82.71062276,144.946475,1.157894737,167.8327605,9.324042248,0.048315492,0
99,62,76,10,11,0,12,3,8,13,15,11,28,28.7548875,96.86408532,2.8125,272.43024,15.13501333,0.032288028,0
17,15,15,0,0,0,2,5,10,6,11,15,17,44.82892142,66.41714013,2.75,182.6471353,10.14706307,0.022139047,0
59,54,48,4,3,0,8,2,20,10,20,22,30,88.4385619,133.7829486,1,133.7829486,7.432386031,0.044594316,0
25,21,19,2,2,0,4,1,4,2,4,5,6,8,13.93156857,0.5,6.965784285,0.386988016,0.004643856,0
94,84,79,2,3,0,12,3,56,30,60,59,90,329.9667631,529.4378744,1.607142857,850.8822982,47.27123879,0.176479291,0
209,166,157,16,16,0,36,7,50,40,80,57,120,301.8442939,699.9468017,5.6,3919.70209,217.7612272,0.233315601,0
93,64,73,6,5,0,15,7,44,34,52,51,86,259.8664757,487.8285794,4.136363636,2017.836397,112.102022,0.162609526,0
168,97,134,6,6,0,28,5,67,62,107,72,169,418.0376162,1042.717325,3.992537313,4163.087828,231.2826571,0.347572442,0
21,19,15,1,1,0,5,2,4,6,8,6,14,10,36.18947501,2,72.37895002,4.021052779,0.012063158,0
32,22,23,0,0,0,9,7,15,14,21,22,35,78.25484339,156.0801067,4.9,764.7925226,42.48847348,0.052026702,0
43,15,34,3,3,0,6,1,35,45,45,36,90,179.5249056,465.2932501,0.642857143,299.1170894,16.61761608,0.15509775,0
129,77,90,18,18,0,21,9,34,26,42,43,68,201.5030616,368.9860033,5.558823529,2051.128077,113.9515598,0.122995334,0
148,86,110,18,18,0,20,9,32,22,38,41,60,188.529325,321.4531203,5.34375,1717.765111,95.43139508,0.10715104,0
40,13,35,0,0,0,5,1,2,2,2,3,4,2,6.339850003,0.5,3.169925001,0.176106945,0.002113283,0
23,20,20,0,0,0,3,4,10,6,11,14,17,41.21928095,64.72503367,2.2,142.3950741,7.910837449,0.021575011,0
23,20,20,0,0,0,3,4,10,6,11,14,17,41.21928095,64.72503367,2.2,142.3950741,7.910837449,0.021575011,0
47,38,35,2,3,0,9,2,5,3,6,7,9,13.60964047,25.2661943,1.2,30.31943316,1.684412953,0.008422065,0
17,10,10,0,0,0,7,1,1,7,7,2,14,0,14,3.5,49,2.722222222,0.004666667,0
22,13,17,0,0,0,5,1,4,4,4,5,8,8,18.57542476,0.5,9.28771238,0.515984021,0.006191808,0
64,50,51,8,2,0,11,1,2,1,2,3,3,2,4.754887502,0.5,2.377443751,0.132080208,0.001584963,0
56,49,48,0,0,0,8,1,6,3,6,7,9,15.509775,25.2661943,0.5,12.63309715,0.701838731,0.008422065,0
33,24,29,3,1,0,3,1,8,5,10,9,15,24,47.54887502,0.625,29.71804689,1.651002605,0.015849625,0
24,12,16,2,2,0,6,1,2,1,2,3,3,2,4.754887502,0.5,2.377443751,0.132080208,0.001584963,0
104,18,15,0,0,78,11,2,3,2,4,5,6,6.754887502,13.93156857,1.333333333,18.57542476,1.031968042,0.004643856,0
314,123,269,9,8,0,37,9,178,147,218,187,365,1359.209876,2754.616478,5.511235955,15181.34138,843.4078542,0.918205493,0
63,34,37,2,2,8,16,10,38,22,44,48,66,232.6405265,368.607525,5.789473684,2134.043566,118.5579759,0.122869175,0
68,24,23,1,1,31,13,4,6,4,8,10,12,23.509775,39.86313714,2.666666667,106.301699,5.905649946,0.013287712,0
26,19,19,2,2,0,5,5,12,6,12,17,18,54.62919048,73.57433114,2.5,183.9358279,10.2186571,0.024524777,0
195,131,112,2,8,34,41,9,56,33,65,65,98,353.7412006,590.1920457,5.223214286,3082.699524,171.2610847,0.196730682,0
93,49,45,2,1,22,25,8,16,11,20,24,31,88,142.1338375,5,710.6691876,39.48162153,0.047377946,0
40,8,7,1,0,21,12,3,6,3,6,9,9,20.26466251,28.52932501,1.5,42.79398752,2.377443751,0.009509775,0
131,66,63,25,25,20,23,10,48,28,54,58,82,301.297481,480.3544416,5.625,2701.993734,150.110763,0.160118147,0
47,20,19,0,0,14,14,6,25,16,27,31,43,131.6061797,213.0304413,3.24,690.21863,38.34547944,0.071010147,0
40,17,16,0,0,12,12,3,15,10,15,18,25,63.35824644,104.248125,1.5,156.3721876,8.687343753,0.034749375,0
54,25,24,0,0,16,14,6,24,15,24,30,39,125.548875,191.3687332,3,574.1061997,31.89478887,0.063789578,0
158,57,62,11,11,57,28,12,35,21,40,47,61,222.5444556,338.82992,6.857142857,2323.405165,129.0780647,0.112943307,0
22,17,16,0,0,2,4,3,5,3,6,8,9,16.36452798,27,1.8,48.6,2.7,0.009,0
51,15,15,0,0,30,6,1,8,4,8,9,12,24,38.03910002,0.5,19.01955001,1.056641667,0.0126797,0
9,4,4,3,3,0,2,1,2,1,2,3,3,2,4.754887502,0.5,2.377443751,0.132080208,0.001584963,0
30,10,13,1,1,9,7,1,4,2,4,5,6,8,13.93156857,0.5,6.965784285,0.386988016,0.004643856,0
26,11,10,0,0,14,2,2,4,2,4,6,6,10,15.509775,1,15.509775,0.861654167,0.005169925,0
22,15,14,0,0,3,5,1,1,1,2,2,3,0,3,1,3,0.166666667,0.001,0
149,82,86,15,16,25,22,4,19,13,23,23,36,88.71062276,162.8482304,2.421052632,394.2641368,21.90356316,0.054282743,0
67,32,34,3,4,19,10,6,16,10,20,22,30,79.509775,133.7829486,3.75,501.6860571,27.87144762,0.044594316,0
14,7,6,0,0,4,4,2,3,2,3,5,5,6.754887502,11.60964047,1,11.60964047,0.644980026,0.00386988,0
16,11,10,0,0,3,3,1,2,1,2,3,3,2,4.754887502,0.5,2.377443751,0.132080208,0.001584963,0
79,56,51,0,4,12,12,8,35,23,44,43,67,203.5249056,363.5597386,5.028571429,1828.186114,101.5658952,0.12118658,0
49,15,13,7,8,19,9,3,4,3,5,7,8,12.7548875,22.45883938,1.875,42.11032383,2.339462435,0.00748628,0
63,45,48,1,1,0,14,9,39,23,43,48,66,234.6600115,368.607525,4.961538462,1828.860413,101.6033563,0.122869175,0
18,15,15,1,1,0,2,5,36,30,53,41,83,197.7269405,444.6768164,3.680555556,1636.657727,90.92542928,0.148225605,0
51,36,37,6,6,0,8,4,12,6,12,16,18,51.01955001,72,2,144,8,0.024,0
32,19,24,4,4,0,4,1,6,3,6,7,9,15.509775,25.2661943,0.5,12.63309715,0.701838731,0.008422065,0
11,7,8,1,1,0,2,1,2,1,2,3,3,2,4.754887502,0.5,2.377443751,0.132080208,0.001584963,0
81,57,62,6,6,0,13,9,60,34,66,69,100,382.9427607,610.8524457,4.95,3023.719606,167.9844226,0.203617482,0
135,92,98,8,8,3,26,7,67,49,92,74,141,426.0794602,875.5329246,4.805970149,4207.7851,233.7658389,0.291844308,0
10,8,8,0,0,0,2,3,6,4,7,9,11,20.26466251,34.86917502,1.75,61.02105628,3.390058682,0.011623058,0
53,35,35,1,1,5,12,2,10,6,12,12,18,35.21928095,64.52932501,1.2,77.43519002,4.301955001,0.021509775,0
76,46,49,7,8,4,15,8,53,38,73,61,111,327.5797841,658.3118445,5.509433962,3626.925634,201.4958685,0.219437281,0
42,26,26,4,4,2,10,3,9,5,10,12,15,33.28421252,53.77443751,1.666666667,89.62406252,4.979114584,0.017924813,0
95,72,71,2,3,0,21,7,25,13,26,32,39,135.7478892,195,3.64,709.8,39.43333333,0.065,0
74,54,57,0,0,4,13,1,34,22,44,35,66,172.9737366,338.5326791,0.647058824,219.0505571,12.16947539,0.112844226,0
147,93,109,3,4,0,34,12,42,35,54,54,89,269.4968818,512.1849877,7.714285714,3951.141334,219.5078519,0.170728329,0
31,21,22,3,3,0,6,5,14,8,16,19,24,64.91260938,101.9502603,2.857142857,291.2864581,16.182581,0.03398342,0
14,8,7,0,0,3,4,1,2,1,2,3,3,2,4.754887502,0.5,2.377443751,0.132080208,0.001584963,0
14,11,10,0,1,0,3,2,5,3,6,7,9,13.60964047,25.2661943,1.2,30.31943316,1.684412953,0.008422065,0
56,41,43,6,6,0,7,3,6,5,7,9,12,20.26466251,38.03910002,1.75,66.56842503,3.698245835,0.0126797,0
45,42,35,0,0,0,10,5,19,14,28,24,42,92.32026323,192.568425,3.684210526,709.4626185,39.41458992,0.064189475,0
21,14,13,0,0,4,4,2,3,3,6,5,9,6.754887502,20.89735285,2,41.79470571,2.321928095,0.006965784,0
18,10,9,0,0,4,5,2,3,2,4,5,6,6.754887502,13.93156857,1.333333333,18.57542476,1.031968042,0.004643856,0
170,95,117,30,29,3,21,6,15,12,18,21,30,74.11313394,131.7695227,3.6,474.3702817,26.35390454,0.043923174,0
21,17,17,0,0,0,4,4,9,7,13,13,20,36.52932501,74.00879436,2.888888889,213.8031837,11.87795465,0.024669598,0
17,11,11,3,3,0,3,3,5,3,6,8,9,16.36452798,27,1.8,48.6,2.7,0.009,0
35,25,25,4,4,0,6,1,2,1,2,3,3,2,4.754887502,0.5,2.377443751,0.132080208,0.001584963,0
87,57,64,0,0,0,23,1,5,10,10,6,20,11.60964047,51.69925001,1,51.69925001,2.872180556,0.017233083,0
258,157,174,17,18,6,60,5,95,76,134,100,210,635.7459233,1395.2098,3.526315789,4919.950347,273.3305748,0.465069933,0
254,157,185,22,22,0,47,6,86,85,109,92,194,568.1685439,1265.571019,3.802325581,4812.113062,267.3396146,0.421857006,0
70,45,43,11,11,0,16,6,27,56,98,33,154,143.8917376,776.8366944,10.88888889,8458.88845,469.9382472,0.258945565,0
52,26,35,5,4,0,13,5,30,82,161,35,243,158.8163583,1246.415773,13.41666667,16722.74496,929.0413864,0.415471924,0
28,20,19,2,2,2,5,2,5,4,6,7,10,13.60964047,28.07354922,1.2,33.68825906,1.871569948,0.00935785,0
38,25,33,0,0,0,5,4,42,43,61,46,104,234.4773318,574.4504434,2.904761905,1668.641764,92.70232024,0.191483481,0
10,6,7,0,0,0,3,1,3,5,5,4,10,4.754887502,20,0.833333333,16.66666667,0.925925926,0.006666667,0
18,11,13,1,1,0,4,2,12,16,16,14,32,45.01955001,121.8353575,1.333333333,162.4471433,9.024841297,0.040611786,0
137,71,90,38,30,0,17,7,81,99,140,88,239,533.1793347,1543.804157,6.049382716,9339.062183,518.836788,0.514601386,0
32,21,20,3,4,0,8,2,16,8,16,18,24,66,100.0782,1,100.0782,5.559900002,0.0333594,0
48,10,25,14,14,2,7,1,8,8,8,9,16,24,50.71880002,0.5,25.35940001,1.408855556,0.016906267,0
10,7,7,0,0,0,3,1,4,2,4,5,6,8,13.93156857,0.5,6.965784285,0.386988016,0.004643856,0
11,7,8,0,0,0,3,1,6,4,8,7,12,15.509775,33.68825906,0.666666667,22.45883938,1.247713299,0.01122942,0
19,12,15,0,0,0,4,1,2,3,3,3,6,2,9.509775004,0.75,7.132331253,0.396240625,0.003169925,0
89,69,75,0,0,0,14,5,38,31,52,43,83,211.030886,450.3799746,3.421052632,1540.773597,85.59853319,0.150126658,0
83,66,70,0,0,0,13,5,48,38,66,53,104,279.6878405,595.7037273,3.4375,2047.731563,113.7628646,0.198567909,0
86,65,74,0,0,0,12,5,50,40,70,55,110,293.80245,635.9495685,3.5,2225.82349,123.6568605,0.211983189,0
85,66,72,0,0,0,13,5,50,40,70,55,110,293.80245,635.9495685,3.5,2225.82349,123.6568605,0.211983189,0
86,27,75,4,4,0,7,3,94,94,140,97,234,620.8862396,1544.379605,2.234042553,3450.209756,191.6783198,0.514793202,0
237,85,211,11,8,0,18,7,165,180,291,172,471,1235.09465,3497.770699,6.172727273,21590.78459,1199.488033,1.165923566,0
251,83,226,10,7,0,18,7,161,175,283,168,458,1199.929102,3385.68138,6.152173913,20829.30066,1157.18337,1.12856046,0
267,62,248,13,6,0,13,6,188,184,346,194,530,1435.772479,4027.953806,5.521276596,22239.44708,1235.524838,1.342651269,0
286,72,263,14,7,0,16,7,226,221,395,233,616,1787.01193,4844.338665,6.117256637,29634.06285,1646.336825,1.614779555,0
43,25,28,8,8,0,7,1,1,1,1,2,2,0,2,0.5,1,0.055555556,0.000666667,0
48,32,36,7,7,0,5,4,27,25,44,31,69,136.3819626,341.8395454,3.259259259,1114.143704,61.89687242,0.113946515,0
89,55,59,10,1,15,14,12,52,31,61,64,92,339.4424154,552,7.038461538,3885.230769,215.8461538,0.184,0
115,67,72,17,20,2,21,7,70,70,134,77,204,448.7012956,1278.424454,6.7,8565.443844,475.8579913,0.426141485,0
117,78,83,14,17,0,17,7,41,34,64,48,98,239.3111166,547.3263251,5.463414634,2990.270654,166.1261474,0.182442108,0
35,18,16,10,8,0,11,8,25,21,38,33,59,140.0964047,297.619253,6.08,1809.525058,100.5291699,0.099206418,0
200,92,107,49,49,4,40,7,178,254,304,185,558,1350.332035,4202.510855,5.97752809,25120.62668,1395.590371,1.400836952,0
69,30,43,11,11,0,15,1,5,6,6,6,12,11.60964047,31.01955001,0.6,18.61173001,1.033985,0.01033985,0
85,68,66,10,10,0,9,3,18,17,24,21,41,79.81353753,180.0850143,2,360.1700287,20.00944604,0.060028338,0
75,56,49,16,16,0,10,3,13,13,18,16,31,52.86060384,124,2.076923077,257.5384615,14.30769231,0.041333333,0
73,42,42,18,18,0,13,2,10,8,11,12,19,35.21928095,68.11428751,1.1,74.92571627,4.162539793,0.022704763,0
67,38,38,18,18,0,11,4,21,14,23,25,37,100.2386659,171.822679,2.19047619,376.3734874,20.90963819,0.057274226,0
11,5,5,3,3,0,3,2,2,2,3,4,5,4,10,1.5,15,0.833333333,0.003333333,0
22,12,12,5,5,0,5,1,1,4,4,2,8,0,8,2,16,0.888888889,0.002666667,0
52,33,34,9,9,0,9,2,4,4,6,6,10,10,25.84962501,1.5,38.77443751,2.154135417,0.008616542,0
53,35,35,9,9,0,9,2,5,4,6,7,10,13.60964047,28.07354922,1.2,33.68825906,1.871569948,0.00935785,0
52,34,34,9,9,0,9,2,4,4,6,6,10,10,25.84962501,1.5,38.77443751,2.154135417,0.008616542,0
100,58,58,31,30,0,12,5,35,25,36,40,61,191.1345461,324.6376138,2.571428571,834.7824355,46.37680197,0.108212538,0
85,51,51,26,25,0,9,5,16,11,18,21,29,75.60964047,127.3772053,2.8125,358.2483898,19.90268832,0.042459068,0
57,33,40,15,13,0,4,7,20,17,31,27,48,106.0900464,228.2346001,5.425,1238.172706,68.78737253,0.0760782,0
92,75,74,3,3,0,15,3,36,19,38,39,57,190.8721876,301.2679265,1.583333333,477.0075503,26.50041946,0.100422642,0
83,52,56,7,7,0,20,4,18,12,24,22,36,83.05865003,160.5395383,2.666666667,428.1054354,23.7836353,0.053513179,0
51,32,34,0,0,11,6,5,24,13,26,29,39,121.6487405,189.4612588,2.708333333,513.1242426,28.50690237,0.063153753,0
78,47,64,0,0,0,14,3,126,77,153,129,230,883.8921579,1612.582269,1.821428571,2937.203418,163.1779677,0.537527423,0
150,113,113,0,0,0,37,3,46,25,49,49,74,258.8387375,415.4885285,1.597826087,663.8784096,36.88213387,0.138496176,0
203,190,181,0,0,0,22,5,64,38,71,69,109,395.6096405,665.8291658,2.7734375,1846.635577,102.5908654,0.221943055,0
175,148,152,2,2,0,21,3,34,22,36,37,58,177.7286241,302.1482952,1.588235294,479.8825865,26.66014369,0.100716098,0
68,59,57,0,2,0,9,3,33,19,33,36,52,171.2198934,268.8361001,1.5,403.2541501,22.40300834,0.089612033,0
27,21,21,0,0,0,6,1,2,4,4,3,8,2,12.67970001,1,12.67970001,0.704427778,0.004226567,0
123,95,91,10,10,0,22,8,48,34,65,56,99,292.0782,574.9281373,5.416666667,3114.194077,173.0107821,0.191642712,0
33,23,27,0,0,0,6,1,4,4,4,5,8,8,18.57542476,0.5,9.28771238,0.515984021,0.006191808,0
27,20,19,1,1,0,7,3,5,4,6,8,10,16.36452798,30,1.8,54,3,0.01,0
480,250,264,18,19,124,73,15,99,69,129,114,198,714.9096643,1352.912223,9.772727273,13221.64218,734.5356765,0.450970741,0
181,53,56,11,11,80,34,2,6,2,6,8,8,17.509775,24,1,24,1.333333333,0.008,0
80,51,50,5,3,7,20,5,13,7,13,18,20,59.71535681,83.39850003,2.5,208.4962501,11.583125,0.0277995,0
258,150,150,13,12,52,44,14,54,40,76,68,116,364.066894,706.1456896,9.851851852,6956.84272,386.4912622,0.235381897,0
36,23,25,0,1,0,10,2,4,2,4,6,6,10,15.509775,1,15.509775,0.861654167,0.005169925,0
25,17,19,0,0,0,6,5,14,9,16,19,25,64.91260938,106.1981878,2.857142857,303.4233938,16.85685521,0.035399396,0
26,17,20,0,0,0,6,5,9,6,10,14,16,40.13896549,60.91767875,2.777777778,169.2157743,9.400876351,0.020305893,0
24,18,18,0,0,0,6,2,10,6,10,12,16,35.21928095,57.35940001,1,57.35940001,3.186633334,0.0191198,0
32,24,24,0,0,0,8,4,8,5,8,12,13,32,46.60451251,2,93.20902502,5.178279168,0.015534838,0
16,12,12,0,0,0,4,1,2,1,2,3,3,2,4.754887502,0.5,2.377443751,0.132080208,0.001584963,0
36,29,29,0,0,0,7,3,8,4,8,11,12,28.7548875,41.51317942,1.5,62.26976914,3.459431619,0.013837726,0
47,34,37,0,0,3,7,2,8,4,8,10,12,26,39.86313714,1,39.86313714,2.21461873,0.013287712,0
208,137,165,0,0,20,23,7,209,122,240,216,362,1630.489543,2807.269276,4.019138756,11282.80474,626.8224858,0.935756425,0
54,22,17,0,0,28,9,5,9,5,10,14,15,40.13896549,57.11032383,2.777777778,158.6397884,8.813321579,0.019036775,0
214,137,163,15,14,0,37,10,36,26,45,46,71,219.336581,392.1728989,6.25,2451.080618,136.1711454,0.1307243,0
212,152,149,22,22,0,41,10,69,45,84,79,129,454.7074685,813.1877165,6.086956522,4949.838274,274.9910152,0.271062572,0
9,5,4,0,0,3,2,1,2,1,2,3,3,2,4.754887502,0.5,2.377443751,0.132080208,0.001584963,0
18,7,5,0,0,9,4,1,1,2,2,2,4,0,4,1,4,0.222222222,0.001333333,0
70,53,54,5,4,0,12,7,23,14,28,30,42,123.6934094,206.089405,4.260869565,878.1200735,48.78444853,0.068696468,0
218,141,144,56,54,0,20,14,79,65,129,93,194,551.301648,1268.596809,11.43037975,14500.54328,805.5857376,0.422865603,0
296,188,199,73,68,0,29,16,95,97,191,111,288,688.1362828,1956.79177,16.08421053,31473.45078,1748.525043,0.652263923,0
23,13,13,2,2,5,3,4,7,4,7,11,11,27.65148445,38.05374781,2,76.10749561,4.228194201,0.012684583,0
30,19,20,2,2,5,3,4,10,5,10,14,15,41.21928095,57.11032383,2,114.2206477,6.345591537,0.019036775,0
49,30,35,2,2,5,7,6,18,9,18,24,27,90.56842503,123.7939875,3,371.3819626,20.63233125,0.041264663,0
8,5,5,0,0,0,3,1,2,1,2,3,3,2,4.754887502,0.5,2.377443751,0.132080208,0.001584963,0
50,33,35,8,7,0,8,1,2,1,2,3,3,2,4.754887502,0.5,2.377443751,0.132080208,0.001584963,0
56,36,40,3,3,0,13,4,8,4,8,12,12,32,43.01955001,2,86.03910002,4.779950001,0.01433985,0
13,10,10,0,0,0,3,2,4,2,4,6,6,10,15.509775,1,15.509775,0.861654167,0.005169925,0
103,62,71,18,18,0,14,3,26,30,49,29,79,126.9663202,383.7804986,2.826923077,1084.917948,60.27321933,0.127926833,0
42,28,27,0,1,0,14,3,8,11,16,11,27,28.7548875,93.4046537,3,280.2139611,15.56744228,0.031134885,0
31,23,22,2,2,0,7,5,11,11,16,16,27,49.66338828,108,3.636363636,392.7272727,21.81818182,0.036,0
40,27,27,3,3,0,10,6,19,14,28,25,42,96.22039776,195.04196,4.421052632,862.2907704,47.9050428,0.065013987,0
32,25,25,0,0,0,7,2,4,3,4,6,7,10,18.09473751,1,18.09473751,1.005263195,0.006031579,0
113,95,98,0,0,3,12,8,30,22,42,38,64,171.2067179,335.8673609,5.6,1880.857221,104.4920678,0.111955787,0
97,76,88,0,0,0,9,4,18,10,19,22,29,83.05865003,129.3235169,2.111111111,273.0163135,15.16757297,0.043107839,0
122,87,98,0,0,0,24,8,63,79,154,71,233,400.5686352,1432.891079,9.777777778,14010.49055,778.360586,0.47763036,0
92,57,67,2,2,0,23,4,43,24,47,47,71,241.3293845,394.3758085,2.186046512,862.1238604,47.89577002,0.131458603,0
20,13,13,2,2,0,5,2,5,4,5,7,9,13.60964047,25.2661943,1,25.2661943,1.403677461,0.008422065,0
29,20,19,0,0,3,7,2,6,4,8,8,12,17.509775,36,1.333333333,48,2.666666667,0.012,0
195,140,141,30,30,0,24,9,81,54,93,90,147,542.0571752,954.3024052,5.166666667,4930.562427,273.9201348,0.318100802,0
33,17,30,0,0,0,3,1,6,6,6,7,12,15.509775,33.68825906,0.5,16.84412953,0.935784974,0.01122942,0
167,109,110,22,20,6,31,5,11,12,20,16,32,49.66338828,128,4.545454545,581.8181818,32.32323232,0.042666667,0
89,71,73,2,2,0,14,3,16,10,20,19,30,68.7548875,127.4378254,1.875,238.9459226,13.27477348,0.042479275,0
72,52,57,0,0,0,15,2,6,4,6,8,10,17.509775,30,1,30,1.666666667,0.01,0
69,65,62,0,0,0,7,9,71,46,92,80,138,465.1613705,872.4260771,5.830985915,5087.104168,282.6168982,0.290808692,0
6,4,4,0,0,0,2,1,2,1,2,3,3,2,4.754887502,0.5,2.377443751,0.132080208,0.001584963,0
54,42,45,0,0,0,9,4,8,10,14,12,24,32,86.03910002,3.5,301.1368501,16.729825,0.0286797,0
48,38,41,0,0,0,7,4,8,10,14,12,24,32,86.03910002,3.5,301.1368501,16.729825,0.0286797,0
14,10,10,0,0,0,4,5,12,6,12,17,18,54.62919048,73.57433114,2.5,183.9358279,10.2186571,0.024524777,0
16,12,12,0,0,0,4,5,12,6,12,17,18,54.62919048,73.57433114,2.5,183.9358279,10.2186571,0.024524777,0
31,21,21,0,0,0,10,2,4,2,4,6,6,10,15.509775,1,15.509775,0.861654167,0.005169925,0
27,19,21,0,0,0,6,1,2,1,2,3,3,2,4.754887502,0.5,2.377443751,0.132080208,0.001584963,0
27,19,21,0,0,0,6,1,2,1,2,3,3,2,4.754887502,0.5,2.377443751,0.132080208,0.001584963,0
25,18,20,1,1,0,4,1,2,1,2,3,3,2,4.754887502,0.5,2.377443751,0.132080208,0.001584963,0
36,26,28,1,1,0,7,1,2,1,2,3,3,2,4.754887502,0.5,2.377443751,0.132080208,0.001584963,0
190,109,110,31,32,3,45,12,81,62,113,93,175,556.5474002,1144.352792,8.37037037,9578.656703,532.1475946,0.381450931,0
110,37,68,23,24,0,18,3,37,39,50,40,89,197.504662,473.6516004,2.027027027,960.1045955,53.33914419,0.157883867,0
40,32,33,1,1,0,6,5,15,10,19,20,29,70.21299941,125.3359148,3.166666667,396.8970634,22.04983685,0.041778638,0
76,36,38,0,0,34,4,4,13,9,14,17,23,56.10571634,94.01164535,2.153846154,202.4866208,11.24925671,0.031337215,0
9,4,7,0,0,0,2,1,1,1,1,2,2,0,2,0.5,1,0.055555556,0.000666667,0
41,25,33,0,0,0,8,2,14,13,14,16,27,55.30296891,108,1,108,6,0.036,0
63,40,53,0,1,4,5,12,48,66,110,60,176,311.09775,1039.612745,13.75,14294.67524,794.1486245,0.346537582,0
12,10,9,0,0,0,3,2,4,2,4,6,6,10,15.509775,1,15.509775,0.861654167,0.005169925,0
13,10,10,0,0,0,3,7,10,7,13,17,20,52.8707654,81.74925683,4.55,371.9591186,20.66439548,0.027249752,0
93,69,75,6,6,0,12,13,30,19,35,43,54,195.3124342,293.0182968,7.583333333,2222.055417,123.4475232,0.097672766,0
63,57,57,0,0,0,6,1,16,16,16,17,32,64,130.7988109,0.5,65.39940546,3.633300303,0.043599604,0
24,17,20,0,0,0,4,6,33,27,49,39,76,181.9747809,401.6905686,4.454545455,1789.348897,99.40827204,0.133896856,0
39,34,34,1,1,0,4,3,18,12,20,21,32,79.81353753,140.5541575,1.666666667,234.2569292,13.01427385,0.046851386,0
25,21,21,1,1,0,3,1,1,1,1,2,2,0,2,0.5,1,0.055555556,0.000666667,0
25,21,21,1,1,0,3,1,1,1,1,2,2,0,2,0.5,1,0.055555556,0.000666667,0
25,21,21,1,1,0,3,1,1,1,1,2,2,0,2,0.5,1,0.055555556,0.000666667,0
29,25,24,2,2,0,3,5,27,29,57,32,86,139.991603,430,5.277777778,2269.444444,126.0802469,0.143333333,0
31,12,30,0,0,0,1,1,2,1,2,3,3,2,4.754887502,0.5,2.377443751,0.132080208,0.001584963,0
114,70,88,2,0,3,23,5,31,24,33,36,57,165.1897261,294.6857251,2.661290323,784.2442684,43.56912602,0.098228575,0
21,12,12,4,4,0,5,2,6,3,6,8,9,17.509775,27,1,27,1.5,0.009,0
11,6,5,0,0,3,3,1,4,2,4,5,6,8,13.93156857,0.5,6.965784285,0.386988016,0.004643856,0
14,8,7,0,0,3,4,1,4,2,4,5,6,8,13.93156857,0.5,6.965784285,0.386988016,0.004643856,0
83,41,40,3,3,16,24,7,18,10,20,25,30,94.71013448,139.3156857,3.888888889,541.7832221,30.0990679,0.046438562,0
34,12,11,0,0,11,12,6,38,21,41,44,62,214.9310205,338.4847604,3.236842105,1095.621724,60.86787357,0.112828253,0
32,12,11,0,0,10,11,6,30,18,35,36,53,162.7164929,274.0060251,3.5,959.0210878,53.27894932,0.091335342,0
36,16,15,0,0,10,11,5,21,13,24,26,37,103.8483064,173.9162696,2.857142857,496.9036273,27.60575707,0.05797209,0
9,5,5,2,2,0,2,1,2,1,2,3,3,2,4.754887502,0.5,2.377443751,0.132080208,0.001584963,0
158,73,80,27,27,19,32,13,131,118,235,144,353,969.4841295,2530.983526,11.66030534,29512.04073,1639.557818,0.843661175,0
32,10,9,0,0,12,11,6,27,17,30,33,47,143.8917376,237.0865236,3.333333333,790.288412,43.90491178,0.079028841,0
37,13,12,3,3,11,11,6,28,22,44,34,66,150.1157128,335.7725475,4.714285714,1582.927724,87.94042911,0.111924183,0
71,21,21,5,5,34,11,6,11,7,12,17,19,53.56352281,77.66179398,3.272727273,254.1658712,14.12032618,0.025887265,0
34,17,15,0,0,10,9,1,2,1,2,3,3,2,4.754887502,0.5,2.377443751,0.132080208,0.001584963,0
227,38,33,0,0,147,47,4,20,11,20,24,31,94.4385619,142.1338375,2,284.267675,15.79264861,0.047377946,0
28,21,21,1,1,0,6,5,10,6,10,15,16,44.82892142,62.51024953,2.5,156.2756238,8.681979101,0.02083675,0
14,9,9,2,2,0,3,2,7,4,8,9,12,21.65148445,38.03910002,1.142857143,43.47325716,2.415180953,0.0126797,0
34,32,29,0,0,0,5,2,6,5,6,8,11,17.509775,33,1,33,1.833333333,0.011,0
98,68,76,7,8,0,14,2,15,14,15,17,29,60.60335893,118.5364224,1,118.5364224,6.5853568,0.039512141,0
21,6,18,1,1,0,2,1,1,12,12,2,24,0,24,6,144,8,0.008,0
44,32,35,0,0,0,9,5,19,23,42,24,65,92.32026323,298.0225625,5.526315789,1646.966793,91.49815517,0.099340854,0
40,29,34,0,0,0,6,4,42,40,77,46,117,234.4773318,646.2567489,3.666666667,2369.608079,131.6448933,0.215418916,0
105,65,79,12,12,0,14,4,14,18,24,18,42,61.30296891,175.1368501,3.428571429,600.4692002,33.35940001,0.05837895,0
75,58,64,1,1,0,10,3,35,22,41,38,63,184.2797931,330.6194333,1.757142857,580.9455757,32.27475421,0.110206478,0
112,65,85,16,16,0,11,3,15,18,22,18,40,63.35824644,166.7970001,2.2,366.9534001,20.38630001,0.055599,0
21,13,17,0,0,0,4,2,6,8,9,8,17,17.509775,51,1.5,76.5,4.25,0.017,0
40,21,24,7,7,3,6,5,11,8,12,16,20,49.66338828,80,2.727272727,218.1818182,12.12121212,0.026666667,0
48,24,38,3,3,0,7,2,63,38,76,65,114,378.5686352,686.5499307,1.206349206,828.218964,46.01216467,0.228849977,0
57,41,46,2,2,0,9,3,35,28,44,38,72,184.2797931,377.850781,1.885714286,712.5186155,39.58436753,0.12595026,0
44,37,32,3,3,0,9,1,4,2,4,5,6,8,13.93156857,0.5,6.965784285,0.386988016,0.004643856,0
35,32,24,3,3,0,8,1,4,2,4,5,6,8,13.93156857,0.5,6.965784285,0.386988016,0.004643856,0
34,22,26,0,3,0,5,1,1,2,2,2,4,0,4,1,4,0.222222222,0.001333333,0
45,21,39,2,2,0,4,1,1,4,4,2,8,0,8,2,16,0.888888889,0.002666667,0
319,217,216,52,48,0,55,6,39,27,48,45,75,221.6404615,411.8889822,3.692307692,1520.820857,84.49004764,0.137296327,0
91,73,70,2,2,0,19,3,16,12,19,19,31,68.7548875,131.6857529,1.78125,234.5652474,13.03140263,0.043895251,0
42,24,27,7,7,0,8,1,1,1,1,2,2,0,2,0.5,1,0.055555556,0.000666667,0
34,27,27,0,0,0,7,3,17,10,19,20,29,74.2417558,125.3359148,1.676470588,210.1219747,11.67344304,0.041778638,0
13,8,8,0,0,0,5,1,6,3,6,7,9,15.509775,25.2661943,0.5,12.63309715,0.701838731,0.008422065,0
9,6,6,0,0,0,3,2,4,2,4,6,6,10,15.509775,1,15.509775,0.861654167,0.005169925,0
36,25,27,2,1,0,8,3,18,10,20,21,30,79.81353753,131.7695227,1.666666667,219.6158711,12.20088173,0.043923174,0
94,65,71,6,6,0,17,4,23,14,28,27,42,112.041925,199.7052751,2.434782609,486.2389307,27.01327393,0.066568425,0
42,29,29,0,0,0,13,1,4,2,4,5,6,8,13.93156857,0.5,6.965784285,0.386988016,0.004643856,0
83,40,39,2,2,21,21,2,19,10,20,21,30,82.71062276,131.7695227,1.052631579,138.7047607,7.70582004,0.043923174,0
11,5,7,1,1,0,3,1,2,1,2,3,3,2,4.754887502,0.5,2.377443751,0.132080208,0.001584963,0
7,5,5,0,0,0,2,1,4,2,4,5,6,8,13.93156857,0.5,6.965784285,0.386988016,0.004643856,0
59,46,49,4,4,0,6,5,16,8,16,21,24,75.60964047,105.4156181,2.5,263.5390454,14.64105808,0.035138539,0
121,100,103,3,3,0,15,4,17,9,17,21,26,77.4868683,114.200253,2,228.400506,12.688917,0.038066751,0
23,12,15,6,6,0,2,1,2,1,2,3,3,2,4.754887502,0.5,2.377443751,0.132080208,0.001584963,0
157,88,121,7,7,4,25,3,82,44,88,85,132,526.0741519,846.0396036,1.609756098,1361.917411,75.66207837,0.282013201,0
16,11,13,0,0,0,3,1,6,3,6,7,9,15.509775,25.2661943,0.5,12.63309715,0.701838731,0.008422065,0
111,48,85,2,5,4,17,2,40,20,40,42,60,214.8771238,323.5390454,1,323.5390454,17.97439141,0.107846348,0
204,118,112,11,9,53,30,9,48,33,62,57,95,296.607525,554.1245513,5.8125,3220.848955,178.936053,0.184708184,0
67,45,49,13,11,0,7,5,16,8,17,21,25,75.60964047,109.8079356,2.65625,291.6773289,16.20429605,0.036602645,0
59,52,52,2,1,0,6,4,9,6,11,13,17,36.52932501,62.90747521,2.444444444,153.7738283,8.54299046,0.020969158,0
7,6,6,0,0,0,1,1,2,1,2,3,3,2,4.754887502,0.5,2.377443751,0.132080208,0.001584963,0
170,114,124,10,10,0,36,4,27,17,32,31,49,136.3819626,242.7556192,2.37037037,575.420727,31.96781817,0.08091854,0
15,6,7,6,6,0,2,1,1,1,1,2,2,0,2,0.5,1,0.055555556,0.000666667,0
97,63,68,4,4,15,10,4,9,8,14,13,22,36.52932501,81.4096738,3.111111111,253.2745407,14.07080782,0.027136558,0
31,21,21,4,4,0,6,1,8,4,8,9,12,24,38.03910002,0.5,19.01955001,1.056641667,0.0126797,0
10,5,5,2,2,0,3,1,2,1,2,3,3,2,4.754887502,0.5,2.377443751,0.132080208,0.001584963,0
18,18,15,0,0,0,3,2,11,6,12,13,18,40.05374781,66.60791493,1.090909091,72.66317992,4.036843329,0.022202638,0
100,76,76,9,9,5,10,3,8,6,11,11,17,28.7548875,58.81033752,2.0625,121.2963211,6.738684507,0.019603446,0
79,56,55,8,8,4,12,2,4,3,4,6,7,10,18.09473751,1,18.09473751,1.005263195,0.006031579,0
46,34,34,4,4,0,8,2,18,9,18,20,27,77.05865003,116.6920586,1,116.6920586,6.482892142,0.038897353,0
31,21,20,1,1,5,5,3,6,3,6,9,9,20.26466251,28.52932501,1.5,42.79398752,2.377443751,0.009509775,0
235,177,175,34,34,0,26,5,46,25,48,51,73,265.6934905,414.08705,2.608695652,1080.227087,60.01261594,0.138029017,0
67,55,58,0,0,0,9,3,19,11,19,22,30,85.46551026,133.7829486,1.5,200.6744228,11.14857905,0.044594316,0
66,55,58,0,0,0,8,3,19,11,19,22,30,85.46551026,133.7829486,1.5,200.6744228,11.14857905,0.044594316,0
67,55,58,0,0,0,9,3,25,16,29,28,45,120.8512922,216.3309715,1.74,376.4158904,20.91199391,0.072110324,0
34,20,27,2,2,0,5,1,4,2,4,5,6,8,13.93156857,0.5,6.965784285,0.386988016,0.004643856,0
23,11,17,2,2,0,4,1,2,1,2,3,3,2,4.754887502,0.5,2.377443751,0.132080208,0.001584963,0
68,55,58,0,0,0,10,3,19,11,19,22,30,85.46551026,133.7829486,1.5,200.6744228,11.14857905,0.044594316,0
120,83,112,0,0,0,8,6,32,21,41,38,62,175.509775,325.3715058,3.84375,1250.646726,69.48037364,0.108457169,0
90,55,70,10,10,0,10,3,9,5,10,12,15,33.28421252,53.77443751,1.666666667,89.62406252,4.979114584,0.017924813,0
19,8,13,0,0,3,3,1,2,1,2,3,3,2,4.754887502,0.5,2.377443751,0.132080208,0.001584963,0
72,58,61,0,0,0,11,4,31,19,35,35,54,161.5800856,276.9812829,2.258064516,625.4416066,34.74675592,0.092327094,0
17,7,10,5,5,0,2,1,4,2,4,5,6,8,13.93156857,0.5,6.965784285,0.386988016,0.004643856,0
78,55,69,0,0,0,9,2,3,3,5,5,8,6.754887502,18.57542476,1.666666667,30.95904127,1.719946737,0.006191808,0
44,25,31,4,4,0,9,1,2,1,2,3,3,2,4.754887502,0.5,2.377443751,0.132080208,0.001584963,0
88,68,68,7,6,0,14,2,16,9,18,18,27,66,112.587975,1.125,126.6614719,7.03674844,0.037529325,0
46,35,35,3,3,0,8,3,10,6,12,13,18,37.97416845,66.60791493,1.8,119.8942469,6.660791493,0.022202638,0
39,32,32,0,0,0,7,2,9,5,9,11,14,30.52932501,48.43204266,1,48.43204266,2.690669037,0.016144014,0
70,37,57,5,5,0,8,1,2,1,2,3,3,2,4.754887502,0.5,2.377443751,0.132080208,0.001584963,0
65,46,56,1,1,0,8,1,1,1,1,2,2,0,2,0.5,1,0.055555556,0.000666667,0
87,56,71,0,0,0,16,1,2,1,2,3,3,2,4.754887502,0.5,2.377443751,0.132080208,0.001584963,0
30,18,24,0,0,0,6,1,1,1,1,2,2,0,2,0.5,1,0.055555556,0.000666667,0
92,72,75,0,0,0,17,6,26,13,26,32,39,137.7212077,195,3,585,32.5,0.065,0
22,16,16,0,0,0,6,1,1,1,1,2,2,0,2,0.5,1,0.055555556,0.000666667,0
47,38,38,1,1,0,8,1,2,1,2,3,3,2,4.754887502,0.5,2.377443751,0.132080208,0.001584963,0
109,71,93,5,3,0,13,1,5,3,6,6,9,11.60964047,23.26466251,0.6,13.9587975,0.77548875,0.007754888,0
159,106,124,16,16,0,19,3,20,27,54,23,81,91.1934494,366.4085184,4.05,1483.9545,82.44191665,0.122136173,0
42,20,33,3,3,0,6,1,4,2,4,5,6,8,13.93156857,0.5,6.965784285,0.386988016,0.004643856,0
219,141,165,19,19,0,35,5,77,48,96,82,144,494.1522041,915.4874887,3.116883117,2853.467497,158.5259721,0.305162496,0
18,15,15,0,0,0,3,1,4,2,4,5,6,8,13.93156857,0.5,6.965784285,0.386988016,0.004643856,0
40,33,33,0,0,0,7,1,1,1,1,2,2,0,2,0.5,1,0.055555556,0.000666667,0
70,59,59,0,0,0,11,3,8,4,8,11,12,28.7548875,41.51317942,1.5,62.26976914,3.459431619,0.013837726,0
15,10,10,0,0,0,5,1,2,2,2,3,4,2,6.339850003,0.5,3.169925001,0.176106945,0.002113283,0
33,17,16,0,0,7,10,3,5,3,5,8,8,16.36452798,24,1.5,36,2,0.008,0
119,97,97,13,6,11,5,10,37,21,38,47,59,225.9690555,327.7207422,5.135135135,1682.890298,93.49390545,0.109240247,0
52,38,42,0,0,0,10,5,16,8,16,21,24,75.60964047,105.4156181,2.5,263.5390454,14.64105808,0.035138539,0
33,28,29,0,0,0,4,3,6,3,6,9,9,20.26466251,28.52932501,1.5,42.79398752,2.377443751,0.009509775,0
28,13,21,0,0,0,7,2,3,2,3,5,5,6.754887502,11.60964047,1,11.60964047,0.644980026,0.00386988,0
56,16,20,3,3,18,15,4,11,12,24,15,36,46.05374781,140.6480614,4.363636364,613.7369954,34.09649974,0.046882687,0
62,43,38,1,1,5,18,9,22,14,25,31,39,126.6368206,193.2136561,5.113636364,988.0243778,54.89024321,0.064404552,0
21,14,13,4,2,0,6,2,3,2,3,5,5,6.754887502,11.60964047,1,11.60964047,0.644980026,0.00386988,0
19,14,13,2,1,0,5,3,7,8,12,10,20,24.40637196,66.4385619,2.571428571,170.8420163,9.491223128,0.022146187,0
16,13,13,0,0,0,3,4,13,8,15,17,23,56.10571634,94.01164535,2.307692308,216.9499508,12.05277504,0.031337215,0
12,9,9,0,0,0,3,1,2,1,2,3,3,2,4.754887502,0.5,2.377443751,0.132080208,0.001584963,0
37,31,31,2,2,0,4,3,7,4,7,10,11,24.40637196,36.54120904,1.5,54.81181357,3.045100754,0.012180403,0
43,29,35,0,2,0,6,3,6,4,8,9,12,20.26466251,38.03910002,2,76.07820003,4.226566669,0.0126797,0
9,8,7,0,0,0,2,3,5,3,6,8,9,16.36452798,27,1.8,48.6,2.7,0.009,0
130,56,74,12,7,25,24,2,4,2,4,6,6,10,15.509775,1,15.509775,0.861654167,0.005169925,0
65,41,45,2,1,0,19,3,11,6,11,14,17,42.80863531,64.72503367,1.5,97.08755051,5.393752806,0.021575011,0
16,14,14,0,0,0,2,4,18,10,20,22,30,83.05865003,133.7829486,2.222222222,297.2954412,16.5164134,0.044594316,0
55,29,26,1,1,16,12,2,6,6,8,8,14,17.509775,42,1.333333333,56,3.111111111,0.014,0
44,27,27,0,0,0,17,3,15,12,24,18,36,63.35824644,150.1173001,2.4,360.2815201,20.01564001,0.0500391,0
28,18,17,5,6,0,5,2,3,2,3,5,5,6.754887502,11.60964047,1,11.60964047,0.644980026,0.00386988,0
14,7,9,3,3,0,2,3,8,5,9,11,14,28.7548875,48.43204266,1.6875,81.72907199,4.540503999,0.016144014,0
12,4,7,2,2,0,3,1,2,1,2,3,3,2,4.754887502,0.5,2.377443751,0.132080208,0.001584963,0
10,3,6,2,2,0,2,2,8,4,8,10,12,26,39.86313714,1,39.86313714,2.21461873,0.013287712,0
13,4,8,2,2,0,3,2,6,3,6,8,9,17.509775,27,1,27,1.5,0.009,0
9,3,7,0,0,0,2,2,6,3,6,8,9,17.509775,27,1,27,1.5,0.009,0
10,4,7,0,0,0,3,2,4,2,4,6,6,10,15.509775,1,15.509775,0.861654167,0.005169925,0
18,11,10,0,0,4,4,3,7,4,7,10,11,24.40637196,36.54120904,1.5,54.81181357,3.045100754,0.012180403,0
9,8,6,0,1,0,2,1,1,1,1,2,2,0,2,0.5,1,0.055555556,0.000666667,0
27,16,13,0,1,8,5,4,7,4,8,11,12,27.65148445,41.51317942,2.285714286,94.88726725,5.271514847,0.013837726,0
94,25,26,9,9,40,19,3,6,4,8,9,12,20.26466251,38.03910002,2,76.07820003,4.226566669,0.0126797,0
17,12,12,0,0,0,5,1,2,1,2,3,3,2,4.754887502,0.5,2.377443751,0.132080208,0.001584963,0
54,17,15,0,1,25,13,4,8,5,9,12,14,32,50.18947501,2.25,112.9263188,6.273684376,0.016729825,0
29,9,8,0,0,14,7,1,2,1,2,3,3,2,4.754887502,0.5,2.377443751,0.132080208,0.001584963,0
56,23,26,1,1,16,13,7,23,19,38,30,57,123.6934094,279.6927639,5.782608696,1617.353809,89.85298938,0.093230921,0
131,74,70,7,6,41,14,11,38,26,48,49,74,237.4749933,415.4885285,6.947368421,2886.551882,160.3639934,0.138496176,0
54,39,34,3,2,8,10,5,15,10,19,20,29,70.21299941,125.3359148,3.166666667,396.8970634,22.04983685,0.041778638,0
83,41,40,0,0,24,19,3,9,5,10,12,15,33.28421252,53.77443751,1.666666667,89.62406252,4.979114584,0.017924813,0
31,15,24,0,0,4,3,1,2,1,2,3,3,2,4.754887502,0.5,2.377443751,0.132080208,0.001584963,0
64,28,34,0,1,14,15,2,6,3,6,8,9,17.509775,27,1,27,1.5,0.009,0
17,19,14,0,0,0,3,3,10,5,10,13,15,37.97416845,55.50659577,1.5,83.25989366,4.625549648,0.018502199,0
19,21,16,0,0,0,3,4,15,11,21,19,32,66.60335893,135.9336804,2.8,380.6143052,21.14523918,0.045311227,0
20,22,17,0,0,0,3,3,16,13,25,19,38,68.7548875,161.4212455,2.34375,378.3310442,21.01839134,0.053807082,0
42,36,37,0,0,0,5,11,35,35,67,46,102,217.5786534,563.4033195,10.52857143,5931.832093,329.5462274,0.187801107,0
8,5,5,0,0,0,3,1,2,1,2,3,3,2,4.754887502,0.5,2.377443751,0.132080208,0.001584963,0
8,5,5,0,0,0,3,1,2,1,2,3,3,2,4.754887502,0.5,2.377443751,0.132080208,0.001584963,0
12,10,10,0,0,0,2,2,6,3,6,8,9,17.509775,27,1,27,1.5,0.009,0
53,30,33,2,2,5,13,4,13,8,16,17,24,56.10571634,98.09910819,2.461538462,241.4747279,13.41526266,0.032699703,0
28,14,20,0,0,4,4,2,11,6,12,13,18,40.05374781,66.60791493,1.090909091,72.66317992,4.036843329,0.022202638,0
29,14,20,0,0,4,5,2,13,7,14,15,21,50.10571634,82.04470251,1.076923077,88.35583347,4.908657415,0.027348234,0
28,14,19,0,0,4,5,2,11,6,12,13,18,40.05374781,66.60791493,1.090909091,72.66317992,4.036843329,0.022202638,0
28,14,19,0,0,4,5,2,11,6,12,13,18,40.05374781,66.60791493,1.090909091,72.66317992,4.036843329,0.022202638,0
26,20,19,0,0,3,4,2,10,7,14,12,21,35.21928095,75.28421252,1.4,105.3978975,5.855438751,0.025094738,0
29,16,17,0,0,8,4,2,8,4,8,10,12,26,39.86313714,1,39.86313714,2.21461873,0.013287712,0
36,24,22,1,1,10,3,4,6,4,8,10,12,23.509775,39.86313714,2.666666667,106.301699,5.905649946,0.013287712,0
74,50,48,3,3,15,8,7,22,21,40,29,61,117.7589801,296.3368407,6.363636364,1885.779895,104.7655497,0.098778947,0
17,7,6,0,0,9,2,1,4,2,4,5,6,8,13.93156857,0.5,6.965784285,0.386988016,0.004643856,0
11,7,7,0,0,3,1,2,3,2,4,5,6,6.754887502,13.93156857,1.333333333,18.57542476,1.031968042,0.004643856,0
33,25,24,0,0,6,3,3,8,5,10,11,15,28.7548875,51.89147428,1.875,97.29651427,5.405361904,0.017297158,0
9,4,4,0,0,4,1,1,4,2,4,5,6,8,13.93156857,0.5,6.965784285,0.386988016,0.004643856,0
8,4,3,0,0,4,1,1,4,2,4,5,6,8,13.93156857,0.5,6.965784285,0.386988016,0.004643856,0
29,18,18,0,0,7,4,6,8,8,16,14,24,39.509775,91.37651813,6,548.2591088,30.45883938,0.030458839,0
26,15,15,0,0,7,4,3,3,3,6,6,9,9.509775004,23.26466251,3,69.79398752,3.877443751,0.007754888,0
148,126,129,10,4,9,6,9,62,61,120,71,181,397.6894963,1113.104229,8.709677419,9694.778765,538.5988203,0.371034743,0
5,5,4,0,0,0,1,1,1,1,1,2,2,0,2,0.5,1,0.055555556,0.000666667,0
18,13,13,0,0,0,5,4,7,4,8,11,12,27.65148445,41.51317942,2.285714286,94.88726725,5.271514847,0.013837726,0
14,9,9,0,0,0,5,2,4,2,4,6,6,10,15.509775,1,15.509775,0.861654167,0.005169925,0
132,85,89,3,3,25,15,15,47,39,73,62,112,319.669035,666.8699868,11.64893617,7768.32591,431.5736616,0.222289996,0
57,30,30,15,15,3,9,6,16,11,19,22,30,79.509775,133.7829486,3.5625,476.6017542,26.47787524,0.044594316,0
44,27,27,8,7,0,10,1,2,1,2,3,3,2,4.754887502,0.5,2.377443751,0.132080208,0.001584963,0
8,5,5,2,2,0,1,1,1,1,1,2,2,0,2,0.5,1,0.055555556,0.000666667,0
5,4,4,0,0,0,1,1,2,1,2,3,3,2,4.754887502,0.5,2.377443751,0.132080208,0.001584963,0
42,20,19,5,5,11,7,4,9,5,9,13,14,36.52932501,51.80615605,2,103.6123121,5.756239562,0.017268719,0
75,52,58,1,2,3,12,6,20,12,23,26,35,101.9483369,164.5153901,3.45,567.578096,31.53211644,0.054838463,0
11,7,7,2,2,0,2,1,2,1,2,3,3,2,4.754887502,0.5,2.377443751,0.132080208,0.001584963,0
24,14,14,4,4,0,6,3,6,4,6,9,10,20.26466251,31.69925001,1.5,47.54887502,2.641604168,0.010566417,0
11,2,7,1,1,0,3,2,4,2,4,6,6,10,15.509775,1,15.509775,0.861654167,0.005169925,0
27,18,22,1,1,0,4,1,4,2,4,5,6,8,13.93156857,0.5,6.965784285,0.386988016,0.004643856,0
21,13,12,0,0,3,6,1,6,3,6,7,9,15.509775,25.2661943,0.5,12.63309715,0.701838731,0.008422065,0
13,9,8,0,1,0,4,1,2,1,2,3,3,2,4.754887502,0.5,2.377443751,0.132080208,0.001584963,0
55,39,37,1,1,9,8,3,6,3,6,9,9,20.26466251,28.52932501,1.5,42.79398752,2.377443751,0.009509775,0
31,20,21,5,5,0,5,4,8,4,8,12,12,32,43.01955001,2,86.03910002,4.779950001,0.01433985,0
20,8,7,4,4,5,4,2,3,2,3,5,5,6.754887502,11.60964047,1,11.60964047,0.644980026,0.00386988,0
219,141,179,10,9,0,31,1,15,24,48,16,72,58.60335893,288,1.6,460.8,25.6,0.096,0
74,55,63,1,0,0,11,3,9,5,10,12,15,33.28421252,53.77443751,1.666666667,89.62406252,4.979114584,0.017924813,0
8,5,5,0,0,0,3,1,2,1,2,3,3,2,4.754887502,0.5,2.377443751,0.132080208,0.001584963,0
77,55,64,0,0,0,13,6,26,17,30,32,47,137.7212077,235,3.461538462,813.4615385,45.19230769,0.078333333,0
38,25,27,3,3,0,8,1,2,2,2,3,4,2,6.339850003,0.5,3.169925001,0.176106945,0.002113283,0
29,18,19,4,4,0,6,4,8,4,8,12,12,32,43.01955001,2,86.03910002,4.779950001,0.01433985,0
28,20,21,0,0,0,7,2,3,2,3,5,5,6.754887502,11.60964047,1,11.60964047,0.644980026,0.00386988,0
24,19,20,0,0,0,4,1,4,2,4,5,6,8,13.93156857,0.5,6.965784285,0.386988016,0.004643856,0
51,20,26,13,13,4,8,1,9,6,12,10,18,28.52932501,59.79470571,0.666666667,39.86313714,2.21461873,0.019931569,0
68,43,36,0,0,23,9,1,1,1,1,2,2,0,2,0.5,1,0.055555556,0.000666667,0
9,7,6,0,1,0,2,1,4,2,4,5,6,8,13.93156857,0.5,6.965784285,0.386988016,0.004643856,0
84,59,44,11,12,18,10,5,47,27,54,52,81,272.6753165,461.7356172,2.872340426,1326.261879,73.68121551,0.153911872,0
56,30,30,10,10,9,7,2,4,2,4,6,6,10,15.509775,1,15.509775,0.861654167,0.005169925,0
37,6,5,0,0,22,10,1,1,1,1,2,2,0,2,0.5,1,0.055555556,0.000666667,0
124,68,66,2,2,17,39,6,15,8,15,21,23,74.11313394,101.0233007,3,303.0699022,16.83721679,0.033674434,0
85,53,51,1,1,7,26,6,14,12,24,20,36,68.81274391,155.5894114,5.142857143,800.1741159,44.45411755,0.051863137,0
16,12,12,0,0,0,4,1,2,1,2,3,3,2,4.754887502,0.5,2.377443751,0.132080208,0.001584963,0
56,32,30,14,13,8,5,2,5,4,5,7,9,13.60964047,25.2661943,1,25.2661943,1.403677461,0.008422065,0
93,20,31,3,3,44,15,3,7,4,8,10,12,24.40637196,39.86313714,1.714285714,68.33680652,3.796489251,0.013287712,0
50,23,26,0,0,12,12,3,15,12,24,18,36,63.35824644,150.1173001,2.4,360.2815201,20.01564001,0.0500391,0
49,17,16,0,0,20,13,4,11,6,12,15,18,46.05374781,70.32403072,2.181818182,153.4342488,8.524124936,0.023441344,0
38,27,30,0,0,3,5,2,3,2,3,5,5,6.754887502,11.60964047,1,11.60964047,0.644980026,0.00386988,0
77,38,37,19,19,3,18,5,10,6,12,15,18,44.82892142,70.32403072,3,210.9720922,11.72067179,0.023441344,0
17,12,12,0,0,0,5,1,2,1,2,3,3,2,4.754887502,0.5,2.377443751,0.132080208,0.001584963,0
345,202,244,10,8,39,54,12,120,97,186,132,283,871.8464215,1993.563536,9.3,18540.14088,1030.007827,0.664521179,0
88,57,53,10,10,0,25,6,14,10,19,20,29,68.81274391,125.3359148,4.071428571,510.2962243,28.34979024,0.041778638,0
10,8,8,0,0,0,2,1,4,2,4,5,6,8,13.93156857,0.5,6.965784285,0.386988016,0.004643856,0
24,18,17,0,0,4,3,6,14,7,14,20,21,68.81274391,90.76048999,3,272.28147,15.12674833,0.030253497,0
26,18,17,0,0,4,5,5,12,6,12,17,18,54.62919048,73.57433114,2.5,183.9358279,10.2186571,0.024524777,0
32,22,21,0,0,4,7,3,8,5,10,11,15,28.7548875,51.89147428,1.875,97.29651427,5.405361904,0.017297158,0
24,15,14,0,0,4,6,1,2,1,2,3,3,2,4.754887502,0.5,2.377443751,0.132080208,0.001584963,0
23,15,14,0,0,4,5,1,2,1,2,3,3,2,4.754887502,0.5,2.377443751,0.132080208,0.001584963,0
21,13,12,0,0,5,4,2,5,3,6,7,9,13.60964047,25.2661943,1.2,30.31943316,1.684412953,0.008422065,0
15,10,9,0,0,4,2,1,2,1,2,3,3,2,4.754887502,0.5,2.377443751,0.132080208,0.001584963,0
13,9,9,0,0,0,4,1,2,1,2,3,3,2,4.754887502,0.5,2.377443751,0.132080208,0.001584963,0
56,32,30,14,13,8,5,2,5,4,5,7,9,13.60964047,25.2661943,1,25.2661943,1.403677461,0.008422065,0
22,14,15,0,0,0,7,2,4,2,4,6,6,10,15.509775,1,15.509775,0.861654167,0.005169925,0
77,39,45,5,5,8,19,5,24,14,28,29,42,121.6487405,204.0352018,2.916666667,595.1026719,33.06125955,0.068011734,0
170,55,60,4,4,49,57,5,8,6,12,13,18,35.60964047,66.60791493,3.75,249.779681,13.87664894,0.022202638,0
170,95,98,9,10,8,54,7,34,26,46,41,72,192.6252211,385.7437443,4.735294118,1826.610083,101.478338,0.128581248,0
99,46,56,4,4,5,34,2,12,7,14,14,21,45.01955001,79.95445336,1.166666667,93.28019559,5.182233088,0.026651484,0
77,37,47,1,0,16,14,4,14,9,16,18,25,61.30296891,104.248125,2.285714286,238.2814287,13.23785715,0.034749375,0
52,38,37,0,0,0,15,2,3,2,3,5,5,6.754887502,11.60964047,1,11.60964047,0.644980026,0.00386988,0
28,20,21,1,1,0,6,2,4,2,4,6,6,10,15.509775,1,15.509775,0.861654167,0.005169925,0
33,22,21,0,0,4,8,1,2,1,2,3,3,2,4.754887502,0.5,2.377443751,0.132080208,0.001584963,0
68,37,35,2,2,9,22,5,12,10,19,17,29,54.62919048,118.5364224,3.958333333,469.206672,26.06703733,0.039512141,0
35,18,16,0,0,9,10,3,10,8,16,13,24,37.97416845,88.81055324,2.4,213.1453278,11.8414071,0.029603518,0
39,15,25,0,0,6,8,1,10,5,10,11,15,33.21928095,51.89147428,0.5,25.94573714,1.441429841,0.017297158,0
27,16,22,0,0,0,5,2,4,3,6,6,9,10,23.26466251,1.5,34.89699376,1.938721876,0.007754888,0
19,13,13,0,0,0,6,4,7,6,12,11,18,27.65148445,62.26976914,3.428571429,213.4963513,11.86090841,0.02075659,0
16,12,12,1,1,0,3,3,4,3,5,7,8,12.7548875,22.45883938,1.875,42.11032383,2.339462435,0.00748628,0
25,14,13,0,0,7,5,1,2,1,2,3,3,2,4.754887502,0.5,2.377443751,0.132080208,0.001584963,0
69,41,40,1,2,7,20,5,13,7,14,18,21,59.71535681,87.56842503,2.692307692,235.7611443,13.09784135,0.029189475,0
35,21,20,1,1,9,5,4,11,6,12,15,18,46.05374781,70.32403072,2.181818182,153.4342488,8.524124936,0.023441344,0
28,13,21,0,0,0,7,2,3,2,3,5,5,6.754887502,11.60964047,1,11.60964047,0.644980026,0.00386988,0
56,16,20,3,3,18,15,4,11,12,24,15,36,46.05374781,140.6480614,4.363636364,613.7369954,34.09649974,0.046882687,0
62,43,38,1,1,5,18,9,22,14,25,31,39,126.6368206,193.2136561,5.113636364,988.0243778,54.89024321,0.064404552,0
21,14,13,4,2,0,6,2,3,2,3,5,5,6.754887502,11.60964047,1,11.60964047,0.644980026,0.00386988,0
19,14,13,2,1,0,5,3,7,8,12,10,20,24.40637196,66.4385619,2.571428571,170.8420163,9.491223128,0.022146187,0
16,13,13,0,0,0,3,4,13,8,15,17,23,56.10571634,94.01164535,2.307692308,216.9499508,12.05277504,0.031337215,0
12,9,9,0,0,0,3,1,2,1,2,3,3,2,4.754887502,0.5,2.377443751,0.132080208,0.001584963,0
37,31,31,2,2,0,4,3,7,4,7,10,11,24.40637196,36.54120904,1.5,54.81181357,3.045100754,0.012180403,0
43,29,35,0,2,0,6,3,6,4,8,9,12,20.26466251,38.03910002,2,76.07820003,4.226566669,0.0126797,0
9,8,7,0,0,0,2,3,5,3,6,8,9,16.36452798,27,1.8,48.6,2.7,0.009,0
130,56,74,12,7,25,24,2,4,2,4,6,6,10,15.509775,1,15.509775,0.861654167,0.005169925,0
65,41,45,2,1,0,19,3,11,6,11,14,17,42.80863531,64.72503367,1.5,97.08755051,5.393752806,0.021575011,0
16,14,14,0,0,0,2,4,18,10,20,22,30,83.05865003,133.7829486,2.222222222,297.2954412,16.5164134,0.044594316,0
55,29,26,1,1,16,12,2,6,6,8,8,14,17.509775,42,1.333333333,56,3.111111111,0.014,0
44,27,27,0,0,0,17,3,15,12,24,18,36,63.35824644,150.1173001,2.4,360.2815201,20.01564001,0.0500391,0
28,18,17,5,6,0,5,2,3,2,3,5,5,6.754887502,11.60964047,1,11.60964047,0.644980026,0.00386988,0
14,7,9,3,3,0,2,3,8,5,9,11,14,28.7548875,48.43204266,1.6875,81.72907199,4.540503999,0.016144014,0
12,4,7,2,2,0,3,1,2,1,2,3,3,2,4.754887502,0.5,2.377443751,0.132080208,0.001584963,0
10,3,6,2,2,0,2,2,8,4,8,10,12,26,39.86313714,1,39.86313714,2.21461873,0.013287712,0
9,3,7,0,0,0,2,2,6,3,6,8,9,17.509775,27,1,27,1.5,0.009,0
10,4,7,0,0,0,3,2,4,2,4,6,6,10,15.509775,1,15.509775,0.861654167,0.005169925,0
18,11,10,0,0,4,4,3,7,4,7,10,11,24.40637196,36.54120904,1.5,54.81181357,3.045100754,0.012180403,0
9,8,6,0,1,0,2,1,1,1,1,2,2,0,2,0.5,1,0.055555556,0.000666667,0
27,16,13,0,1,8,5,4,7,4,8,11,12,27.65148445,41.51317942,2.285714286,94.88726725,5.271514847,0.013837726,0
94,25,26,9,9,40,19,3,6,4,8,9,12,20.26466251,38.03910002,2,76.07820003,4.226566669,0.0126797,0
17,12,12,0,0,0,5,1,2,1,2,3,3,2,4.754887502,0.5,2.377443751,0.132080208,0.001584963,0
54,17,15,0,1,25,13,4,8,5,9,12,14,32,50.18947501,2.25,112.9263188,6.273684376,0.016729825,0
29,9,8,0,0,14,7,1,2,1,2,3,3,2,4.754887502,0.5,2.377443751,0.132080208,0.001584963,0
56,23,26,1,1,16,13,7,23,19,38,30,57,123.6934094,279.6927639,5.782608696,1617.353809,89.85298938,0.093230921,0
131,74,70,7,6,41,14,11,38,26,48,49,74,237.4749933,415.4885285,6.947368421,2886.551882,160.3639934,0.138496176,0
54,39,34,3,2,8,10,5,15,10,19,20,29,70.21299941,125.3359148,3.166666667,396.8970634,22.04983685,0.041778638,0
83,41,40,0,0,24,19,3,9,5,10,12,15,33.28421252,53.77443751,1.666666667,89.62406252,4.979114584,0.017924813,0
31,15,24,0,0,4,3,1,2,1,2,3,3,2,4.754887502,0.5,2.377443751,0.132080208,0.001584963,0
64,28,34,0,1,14,15,2,6,3,6,8,9,17.509775,27,1,27,1.5,0.009,0
17,19,14,0,0,0,3,3,10,5,10,13,15,37.97416845,55.50659577,1.5,83.25989366,4.625549648,0.018502199,0
17,19,14,0,0,0,3,3,10,5,10,13,15,37.97416845,55.50659577,1.5,83.25989366,4.625549648,0.018502199,0
19,21,16,0,0,0,3,4,15,11,21,19,32,66.60335893,135.9336804,2.8,380.6143052,21.14523918,0.045311227,0
20,22,17,0,0,0,3,3,16,13,25,19,38,68.7548875,161.4212455,2.34375,378.3310442,21.01839134,0.053807082,0
42,36,37,0,0,0,5,11,35,35,67,46,102,217.5786534,563.4033195,10.52857143,5931.832093,329.5462274,0.187801107,0
8,5,5,0,0,0,3,1,2,1,2,3,3,2,4.754887502,0.5,2.377443751,0.132080208,0.001584963,0
8,5,5,0,0,0,3,1,2,1,2,3,3,2,4.754887502,0.5,2.377443751,0.132080208,0.001584963,0
9,6,6,0,0,0,3,1,2,1,2,3,3,2,4.754887502,0.5,2.377443751,0.132080208,0.001584963,0
12,10,10,0,0,0,2,2,6,3,6,8,9,17.509775,27,1,27,1.5,0.009,0
53,30,33,2,2,5,13,4,13,8,16,17,24,56.10571634,98.09910819,2.461538462,241.4747279,13.41526266,0.032699703,0
28,14,20,0,0,4,4,2,11,6,12,13,18,40.05374781,66.60791493,1.090909091,72.66317992,4.036843329,0.022202638,0
29,14,20,0,0,4,5,2,13,7,14,15,21,50.10571634,82.04470251,1.076923077,88.35583347,4.908657415,0.027348234,0
28,14,19,0,0,4,5,2,11,6,12,13,18,40.05374781,66.60791493,1.090909091,72.66317992,4.036843329,0.022202638,0
26,20,19,0,0,3,4,2,10,7,14,12,21,35.21928095,75.28421252,1.4,105.3978975,5.855438751,0.025094738,0
29,16,17,0,0,8,4,2,8,4,8,10,12,26,39.86313714,1,39.86313714,2.21461873,0.013287712,0
36,24,22,1,1,10,3,4,6,4,8,10,12,23.509775,39.86313714,2.666666667,106.301699,5.905649946,0.013287712,0
74,50,48,3,3,15,8,7,22,21,40,29,61,117.7589801,296.3368407,6.363636364,1885.779895,104.7655497,0.098778947,0
17,7,6,0,0,9,2,1,4,2,4,5,6,8,13.93156857,0.5,6.965784285,0.386988016,0.004643856,0
11,7,7,0,0,3,1,2,3,2,4,5,6,6.754887502,13.93156857,1.333333333,18.57542476,1.031968042,0.004643856,0
33,25,24,0,0,6,3,3,8,5,10,11,15,28.7548875,51.89147428,1.875,97.29651427,5.405361904,0.017297158,0
9,4,4,0,0,4,1,1,4,2,4,5,6,8,13.93156857,0.5,6.965784285,0.386988016,0.004643856,0
8,4,3,0,0,4,1,1,4,2,4,5,6,8,13.93156857,0.5,6.965784285,0.386988016,0.004643856,0
29,18,18,0,0,7,4,6,8,8,16,14,24,39.509775,91.37651813,6,548.2591088,30.45883938,0.030458839,0
26,15,15,0,0,7,4,3,3,3,6,6,9,9.509775004,23.26466251,3,69.79398752,3.877443751,0.007754888,0
148,126,129,10,4,9,6,9,62,61,120,71,181,397.6894963,1113.104229,8.709677419,9694.778765,538.5988203,0.371034743,0
5,5,4,0,0,0,1,1,1,1,1,2,2,0,2,0.5,1,0.055555556,0.000666667,0
18,13,13,0,0,0,5,4,7,4,8,11,12,27.65148445,41.51317942,2.285714286,94.88726725,5.271514847,0.013837726,0
14,9,9,0,0,0,5,2,4,2,4,6,6,10,15.509775,1,15.509775,0.861654167,0.005169925,0
132,85,89,3,3,25,15,15,47,39,73,62,112,319.669035,666.8699868,11.64893617,7768.32591,431.5736616,0.222289996,0
57,30,30,15,15,3,9,6,16,11,19,22,30,79.509775,133.7829486,3.5625,476.6017542,26.47787524,0.044594316,0
44,27,27,8,7,0,10,1,2,1,2,3,3,2,4.754887502,0.5,2.377443751,0.132080208,0.001584963,0
8,5,5,2,2,0,1,1,1,1,1,2,2,0,2,0.5,1,0.055555556,0.000666667,0
5,4,4,0,0,0,1,1,2,1,2,3,3,2,4.754887502,0.5,2.377443751,0.132080208,0.001584963,0
42,20,19,5,5,11,7,4,9,5,9,13,14,36.52932501,51.80615605,2,103.6123121,5.756239562,0.017268719,0
75,52,58,1,2,3,12,6,20,12,23,26,35,101.9483369,164.5153901,3.45,567.578096,31.53211644,0.054838463,0
12,5,9,0,0,0,3,1,2,1,2,3,3,2,4.754887502,0.5,2.377443751,0.132080208,0.001584963,0
11,7,7,2,2,0,2,1,2,1,2,3,3,2,4.754887502,0.5,2.377443751,0.132080208,0.001584963,0
9,7,7,0,0,0,2,1,2,1,2,3,3,2,4.754887502,0.5,2.377443751,0.132080208,0.001584963,0
10,8,6,0,1,0,3,1,2,1,2,3,3,2,4.754887502,0.5,2.377443751,0.132080208,0.001584963,0
11,7,7,2,2,0,2,1,2,1,2,3,3,2,4.754887502,0.5,2.377443751,0.132080208,0.001584963,0
24,14,14,4,4,0,6,3,6,4,6,9,10,20.26466251,31.69925001,1.5,47.54887502,2.641604168,0.010566417,0
11,2,7,1,1,0,3,2,4,2,4,6,6,10,15.509775,1,15.509775,0.861654167,0.005169925,0
27,18,22,1,1,0,4,1,4,2,4,5,6,8,13.93156857,0.5,6.965784285,0.386988016,0.004643856,0
21,13,12,0,0,3,6,1,6,3,6,7,9,15.509775,25.2661943,0.5,12.63309715,0.701838731,0.008422065,0
13,9,8,0,1,0,4,1,2,1,2,3,3,2,4.754887502,0.5,2.377443751,0.132080208,0.001584963,0
55,39,37,1,1,9,8,3,6,3,6,9,9,20.26466251,28.52932501,1.5,42.79398752,2.377443751,0.009509775,0
31,20,21,5,5,0,5,4,8,4,8,12,12,32,43.01955001,2,86.03910002,4.779950001,0.01433985,0
20,8,7,4,4,5,4,2,3,2,3,5,5,6.754887502,11.60964047,1,11.60964047,0.644980026,0.00386988,0
219,141,179,10,9,0,31,1,15,24,48,16,72,58.60335893,288,1.6,460.8,25.6,0.096,0
74,55,63,1,0,0,11,3,9,5,10,12,15,33.28421252,53.77443751,1.666666667,89.62406252,4.979114584,0.017924813,0
8,5,5,0,0,0,3,1,2,1,2,3,3,2,4.754887502,0.5,2.377443751,0.132080208,0.001584963,0
34,21,21,0,0,9,4,2,4,2,4,6,6,10,15.509775,1,15.509775,0.861654167,0.005169925,0
77,55,64,0,0,0,13,6,26,17,30,32,47,137.7212077,235,3.461538462,813.4615385,45.19230769,0.078333333,0
38,25,27,3,3,0,8,1,2,2,2,3,4,2,6.339850003,0.5,3.169925001,0.176106945,0.002113283,0
29,18,19,4,4,0,6,4,8,4,8,12,12,32,43.01955001,2,86.03910002,4.779950001,0.01433985,0
28,20,21,0,0,0,7,2,3,2,3,5,5,6.754887502,11.60964047,1,11.60964047,0.644980026,0.00386988,0
24,19,20,0,0,0,4,1,4,2,4,5,6,8,13.93156857,0.5,6.965784285,0.386988016,0.004643856,0
51,20,26,13,13,4,8,1,9,6,12,10,18,28.52932501,59.79470571,0.666666667,39.86313714,2.21461873,0.019931569,0
68,43,36,0,0,23,9,1,1,1,1,2,2,0,2,0.5,1,0.055555556,0.000666667,0
9,7,6,0,1,0,2,1,4,2,4,5,6,8,13.93156857,0.5,6.965784285,0.386988016,0.004643856,0
84,59,44,11,12,18,10,5,47,27,54,52,81,272.6753165,461.7356172,2.872340426,1326.261879,73.68121551,0.153911872,0
56,30,30,10,10,9,7,2,4,2,4,6,6,10,15.509775,1,15.509775,0.861654167,0.005169925,0
37,6,5,0,0,22,10,1,1,1,1,2,2,0,2,0.5,1,0.055555556,0.000666667,0
124,68,66,2,2,17,39,6,15,8,15,21,23,74.11313394,101.0233007,3,303.0699022,16.83721679,0.033674434,0
85,53,51,1,1,7,26,6,14,12,24,20,36,68.81274391,155.5894114,5.142857143,800.1741159,44.45411755,0.051863137,0
16,12,12,0,0,0,4,1,2,1,2,3,3,2,4.754887502,0.5,2.377443751,0.132080208,0.001584963,0
56,32,30,14,13,8,5,2,5,4,5,7,9,13.60964047,25.2661943,1,25.2661943,1.403677461,0.008422065,0
93,20,31,3,3,44,15,3,7,4,8,10,12,24.40637196,39.86313714,1.714285714,68.33680652,3.796489251,0.013287712,0
50,23,26,0,0,12,12,3,15,12,24,18,36,63.35824644,150.1173001,2.4,360.2815201,20.01564001,0.0500391,0
49,17,16,0,0,20,13,4,11,6,12,15,18,46.05374781,70.32403072,2.181818182,153.4342488,8.524124936,0.023441344,0
38,27,30,0,0,3,5,2,3,2,3,5,5,6.754887502,11.60964047,1,11.60964047,0.644980026,0.00386988,0
77,38,37,19,19,3,18,5,10,6,12,15,18,44.82892142,70.32403072,3,210.9720922,11.72067179,0.023441344,0
17,12,12,0,0,0,5,1,2,1,2,3,3,2,4.754887502,0.5,2.377443751,0.132080208,0.001584963,0
345,202,244,10,8,39,54,12,120,97,186,132,283,871.8464215,1993.563536,9.3,18540.14088,1030.007827,0.664521179,0
88,57,53,10,10,0,25,6,14,10,19,20,29,68.81274391,125.3359148,4.071428571,510.2962243,28.34979024,0.041778638,0
10,8,8,0,0,0,2,1,4,2,4,5,6,8,13.93156857,0.5,6.965784285,0.386988016,0.004643856,0
24,18,17,0,0,4,3,6,14,7,14,20,21,68.81274391,90.76048999,3,272.28147,15.12674833,0.030253497,0
26,18,17,0,0,4,5,5,12,6,12,17,18,54.62919048,73.57433114,2.5,183.9358279,10.2186571,0.024524777,0
32,22,21,0,0,4,7,3,8,5,10,11,15,28.7548875,51.89147428,1.875,97.29651427,5.405361904,0.017297158,0
24,15,14,0,0,4,6,1,2,1,2,3,3,2,4.754887502,0.5,2.377443751,0.132080208,0.001584963,0
23,15,14,0,0,4,5,1,2,1,2,3,3,2,4.754887502,0.5,2.377443751,0.132080208,0.001584963,0
21,13,12,0,0,5,4,2,5,3,6,7,9,13.60964047,25.2661943,1.2,30.31943316,1.684412953,0.008422065,0
15,10,9,0,0,4,2,1,2,1,2,3,3,2,4.754887502,0.5,2.377443751,0.132080208,0.001584963,0
13,9,9,0,0,0,4,1,2,1,2,3,3,2,4.754887502,0.5,2.377443751,0.132080208,0.001584963,0
56,32,30,14,13,8,5,2,5,4,5,7,9,13.60964047,25.2661943,1,25.2661943,1.403677461,0.008422065,0
31,19,20,2,2,0,9,1,2,1,2,3,3,2,4.754887502,0.5,2.377443751,0.132080208,0.001584963,0
22,14,15,0,0,0,7,2,4,2,4,6,6,10,15.509775,1,15.509775,0.861654167,0.005169925,0
77,39,45,5,5,8,19,5,24,14,28,29,42,121.6487405,204.0352018,2.916666667,595.1026719,33.06125955,0.068011734,0
170,55,60,4,4,49,57,5,8,6,12,13,18,35.60964047,66.60791493,3.75,249.779681,13.87664894,0.022202638,0
170,95,98,9,10,8,54,7,34,26,46,41,72,192.6252211,385.7437443,4.735294118,1826.610083,101.478338,0.128581248,0
99,46,56,4,4,5,34,2,12,7,14,14,21,45.01955001,79.95445336,1.166666667,93.28019559,5.182233088,0.026651484,0
77,37,47,1,0,16,14,4,14,9,16,18,25,61.30296891,104.248125,2.285714286,238.2814287,13.23785715,0.034749375,0
52,38,37,0,0,0,15,2,3,2,3,5,5,6.754887502,11.60964047,1,11.60964047,0.644980026,0.00386988,0
28,20,21,1,1,0,6,2,4,2,4,6,6,10,15.509775,1,15.509775,0.861654167,0.005169925,0
33,22,21,0,0,4,8,1,2,1,2,3,3,2,4.754887502,0.5,2.377443751,0.132080208,0.001584963,0
68,37,35,2,2,9,22,5,12,10,19,17,29,54.62919048,118.5364224,3.958333333,469.206672,26.06703733,0.039512141,0
35,18,16,0,0,9,10,3,10,8,16,13,24,37.97416845,88.81055324,2.4,213.1453278,11.8414071,0.029603518,0
39,15,25,0,0,6,8,1,10,5,10,11,15,33.21928095,51.89147428,0.5,25.94573714,1.441429841,0.017297158,0
27,16,22,0,0,0,5,2,4,3,6,6,9,10,23.26466251,1.5,34.89699376,1.938721876,0.007754888,0
19,13,13,0,0,0,6,4,7,6,12,11,18,27.65148445,62.26976914,3.428571429,213.4963513,11.86090841,0.02075659,0
16,12,12,1,1,0,3,3,4,3,5,7,8,12.7548875,22.45883938,1.875,42.11032383,2.339462435,0.00748628,0
25,14,13,0,0,7,5,1,2,1,2,3,3,2,4.754887502,0.5,2.377443751,0.132080208,0.001584963,0
69,41,40,1,2,7,20,5,13,7,14,18,21,59.71535681,87.56842503,2.692307692,235.7611443,13.09784135,0.029189475,0
35,21,20,1,1,9,5,4,11,6,12,15,18,46.05374781,70.32403072,2.181818182,153.4342488,8.524124936,0.023441344,0
41,23,35,0,0,0,6,1,4,4,4,5,8,8,18.57542476,0.5,9.28771238,0.515984021,0.006191808,0
44,34,34,4,4,0,6,3,10,7,12,13,19,37.97416845,70.30835464,1.8,126.5550384,7.030835464,0.023436118,0
23,18,18,0,0,0,5,4,9,7,12,13,19,36.52932501,70.30835464,2.666666667,187.4889457,10.41605254,0.023436118,0
64,55,52,5,5,0,7,7,17,16,28,24,44,89.13835276,201.73835,5.764705882,1162.962253,64.60901406,0.067246117,0
23,17,14,2,3,2,4,1,2,1,2,3,3,2,4.754887502,0.5,2.377443751,0.132080208,0.001584963,0
24,20,20,1,0,0,4,4,8,5,10,12,15,32,53.77443751,2.5,134.4360938,7.468671877,0.017924813,0
38,28,22,6,10,0,6,1,24,12,24,25,36,110.0391,167.1788228,0.5,83.58941142,4.64385619,0.055726274,0
1715,1293,1226,141,224,13,252,2,5,3,5,7,8,13.60964047,22.45883938,1,22.45883938,1.247713299,0.00748628,0
39,23,25,9,9,0,5,3,10,5,10,13,15,37.97416845,55.50659577,1.5,83.25989366,4.625549648,0.018502199,0
21,9,16,0,0,0,5,2,5,4,5,7,9,13.60964047,25.2661943,1,25.2661943,1.403677461,0.008422065,0
21,9,16,0,0,0,5,2,5,4,5,7,9,13.60964047,25.2661943,1,25.2661943,1.403677461,0.008422065,0
1142,751,768,106,107,119,148,19,197,208,362,216,570,1582.254831,4420.285876,17.45685279,77164.27984,4286.904436,1.473428625,0
17,13,11,3,3,0,3,1,2,1,2,3,3,2,4.754887502,0.5,2.377443751,0.132080208,0.001584963,0
40,26,21,7,11,0,8,4,32,25,47,36,72,168,372.2346001,2.9375,1093.439138,60.74661877,0.1240782,0
71,29,57,6,6,0,8,1,12,6,12,13,18,43.01955001,66.60791493,0.5,33.30395746,1.850219859,0.022202638,0
18,13,13,2,2,0,3,3,9,6,10,12,16,33.28421252,57.35940001,1.666666667,95.59900002,5.311055557,0.0191198,0
45,35,35,3,3,0,7,2,7,5,7,9,12,21.65148445,38.03910002,1,38.03910002,2.113283334,0.0126797,0
72,38,41,17,17,4,10,6,16,9,17,22,26,79.509775,115.9452221,3.1875,369.5753954,20.53196641,0.038648407,0
27,16,21,0,0,0,6,1,2,1,2,3,3,2,4.754887502,0.5,2.377443751,0.132080208,0.001584963,0
41,35,35,0,0,0,6,1,18,9,18,19,27,75.05865003,114.6940429,0.5,57.34702143,3.185945635,0.038231348,0
101,75,82,6,1,2,16,1,2,1,2,3,3,2,4.754887502,0.5,2.377443751,0.132080208,0.001584963,0
24,16,20,0,0,0,4,2,4,6,12,6,18,10,46.52932501,3,139.587975,7.754887502,0.015509775,0
27,22,22,0,0,0,5,2,4,6,12,6,18,10,46.52932501,3,139.587975,7.754887502,0.015509775,0
20,12,15,0,0,0,5,3,9,6,10,12,16,33.28421252,57.35940001,1.666666667,95.59900002,5.311055557,0.0191198,0
27,13,21,0,0,0,6,2,8,4,8,10,12,26,39.86313714,1,39.86313714,2.21461873,0.013287712,0
23,22,19,2,2,0,2,2,20,12,24,22,36,88.4385619,160.5395383,1.2,192.6474459,10.70263588,0.053513179,0
49,39,39,3,3,0,7,6,57,50,99,63,149,347.9845058,890.6147086,5.210526316,4640.571376,257.8095209,0.29687157,0
36,29,29,1,1,0,6,3,21,20,38,24,58,96.99355338,265.927825,2.714285714,721.8040965,40.10022759,0.088642608,0
46,43,43,0,0,0,3,4,45,42,83,49,125,255.1333893,701.8387305,3.688888889,2589.005095,143.8336164,0.233946244,0
45,38,38,2,1,0,6,7,50,42,83,57,125,301.8442939,729.1112518,5.81,4236.136373,235.3409096,0.243037084,0
34,24,25,0,0,0,9,1,2,1,2,3,3,2,4.754887502,0.5,2.377443751,0.132080208,0.001584963,0
9,4,4,0,0,0,5,1,2,1,2,3,3,2,4.754887502,0.5,2.377443751,0.132080208,0.001584963,0
31,22,24,0,0,0,7,1,9,26,26,10,52,28.52932501,172.7402609,1.444444444,249.5137102,13.86187279,0.057580087,0
56,9,8,2,2,34,12,2,3,2,3,5,5,6.754887502,11.60964047,1,11.60964047,0.644980026,0.00386988,0
63,41,39,0,1,10,13,4,14,8,16,18,24,61.30296891,100.0782,2.285714286,228.7501715,12.70834286,0.0333594,0
158,72,66,11,11,63,18,12,37,30,60,49,90,235.7693245,505.323886,9.72972973,4916.664836,273.1480465,0.168441295,0
223,52,190,0,0,0,33,1,4,2,4,5,6,8,13.93156857,0.5,6.965784285,0.386988016,0.004643856,0
50,41,37,0,5,0,8,1,2,1,2,3,3,2,4.754887502,0.5,2.377443751,0.132080208,0.001584963,0
34,25,25,0,0,0,9,4,9,5,9,13,14,36.52932501,51.80615605,2,103.6123121,5.756239562,0.017268719,0
84,60,62,16,16,0,6,5,10,5,10,15,15,44.82892142,58.60335893,2.5,146.5083973,8.139355408,0.019534453,0
20,14,13,2,2,0,5,1,2,1,2,3,3,2,4.754887502,0.5,2.377443751,0.132080208,0.001584963,0
17,15,15,0,0,0,2,4,7,4,7,11,11,27.65148445,38.05374781,2,76.10749561,4.228194201,0.012684583,0
53,36,44,1,1,0,8,1,12,9,18,13,27,43.01955001,99.91187239,0.75,74.93390429,4.162994683,0.033303957,0
20,14,14,0,0,0,6,2,20,12,24,22,36,88.4385619,160.5395383,1.2,192.6474459,10.70263588,0.053513179,0
80,61,56,11,11,0,13,1,1,1,1,2,2,0,2,0.5,1,0.055555556,0.000666667,0
33,26,26,2,2,0,5,1,5,5,5,6,10,11.60964047,25.84962501,0.5,12.9248125,0.718045139,0.008616542,0
36,17,16,11,13,0,7,1,4,2,4,5,6,8,13.93156857,0.5,6.965784285,0.386988016,0.004643856,0
100,44,47,30,31,6,16,5,16,11,17,21,28,75.60964047,122.9848878,2.65625,326.6786083,18.14881157,0.040994963,0
20,9,14,0,0,3,3,2,4,3,4,6,7,10,18.09473751,1,18.09473751,1.005263195,0.006031579,0
5,2,2,0,0,0,3,1,2,1,2,3,3,2,4.754887502,0.5,2.377443751,0.132080208,0.001584963,0
21,11,18,1,1,0,2,2,3,2,3,5,5,6.754887502,11.60964047,1,11.60964047,0.644980026,0.00386988,0
32,20,20,2,2,5,5,3,8,4,8,11,12,28.7548875,41.51317942,1.5,62.26976914,3.459431619,0.013837726,0
20,16,16,0,0,0,4,2,3,2,3,5,5,6.754887502,11.60964047,1,11.60964047,0.644980026,0.00386988,0
20,9,11,0,0,9,0,5,12,6,12,17,18,54.62919048,73.57433114,2.5,183.9358279,10.2186571,0.024524777,0
22,13,13,3,2,0,7,1,2,1,2,3,3,2,4.754887502,0.5,2.377443751,0.132080208,0.001584963,0
61,30,27,0,0,22,12,2,6,3,6,8,9,17.509775,27,1,27,1.5,0.009,0
65,32,29,13,13,11,12,6,17,9,17,23,26,84.99664331,117.6126109,3,352.8378326,19.60210181,0.039204204,0
24,14,16,0,0,3,5,1,1,1,1,2,2,0,2,0.5,1,0.055555556,0.000666667,0
36,27,28,3,3,0,5,2,3,2,3,5,5,6.754887502,11.60964047,1,11.60964047,0.644980026,0.00386988,0
77,50,44,11,11,17,5,4,21,12,24,25,36,100.2386659,167.1788228,2.285714286,382.1230236,21.22905687,0.055726274,0
18,17,13,2,1,0,4,4,12,6,12,16,18,51.01955001,72,2,144,8,0.024,0
35,18,22,10,10,0,3,5,13,7,14,18,21,59.71535681,87.56842503,2.692307692,235.7611443,13.09784135,0.029189475,0
68,41,58,2,1,0,9,4,18,9,18,22,27,83.05865003,120.4046537,2,240.8093074,13.37829486,0.040134885,0
86,53,50,16,16,8,12,2,3,2,3,5,5,6.754887502,11.60964047,1,11.60964047,0.644980026,0.00386988,0
58,30,28,10,10,14,6,6,24,13,26,30,39,125.548875,191.3687332,3.25,621.948383,34.55268794,0.063789578,0
15,8,6,0,0,7,2,1,1,1,1,2,2,0,2,0.5,1,0.055555556,0.000666667,0
92,60,49,7,18,8,17,3,5,3,5,8,8,16.36452798,24,1.5,36,2,0.008,0
19,15,12,0,3,0,4,4,8,5,8,12,13,32,46.60451251,2,93.20902502,5.178279168,0.015534838,0
154,94,86,13,20,24,24,6,21,13,24,27,37,107.7484409,175.9308376,3.428571429,603.1914431,33.51063573,0.058643613,0
60,39,38,4,4,5,13,3,13,7,13,16,20,52.86060384,80,1.5,120,6.666666667,0.026666667,0
12,9,8,1,2,0,2,1,2,1,2,3,3,2,4.754887502,0.5,2.377443751,0.132080208,0.001584963,0
153,72,61,45,44,18,30,10,64,42,80,74,122,417.2192809,757.5533106,6.25,4734.708191,263.039344,0.25251777,0
55,39,42,4,3,3,7,6,9,6,11,15,17,44.03910002,66.41714013,3.666666667,243.5295138,13.52941743,0.022139047,0
59,33,36,2,2,13,8,3,6,3,6,9,9,20.26466251,28.52932501,1.5,42.79398752,2.377443751,0.009509775,0
39,23,23,0,0,11,5,1,2,1,2,3,3,2,4.754887502,0.5,2.377443751,0.132080208,0.001584963,0
56,35,30,2,2,15,9,2,4,3,4,6,7,10,18.09473751,1,18.09473751,1.005263195,0.006031579,0
29,16,18,2,2,5,4,2,5,4,6,7,10,13.60964047,28.07354922,1.2,33.68825906,1.871569948,0.00935785,0
302,191,230,20,20,26,26,10,83,49,94,93,143,562.3475538,935.09971,5.662650602,5295.142936,294.1746076,0.311699903,0
36,29,34,0,0,0,2,3,10,8,15,13,23,37.97416845,85.11011352,2.25,191.4977554,10.63876419,0.028370038,0
23,14,15,0,0,5,3,2,4,2,4,6,6,10,15.509775,1,15.509775,0.861654167,0.005169925,0
24,21,21,1,0,0,3,2,3,2,3,5,5,6.754887502,11.60964047,1,11.60964047,0.644980026,0.00386988,0
47,33,35,2,2,0,10,6,21,11,21,27,32,107.7484409,152.1564001,3,456.4692002,25.35940001,0.0507188,0
41,24,22,3,3,6,10,7,13,7,14,20,21,67.75720079,90.76048999,3.769230769,342.0972315,19.00540175,0.030253497,0
93,61,71,4,4,3,15,9,37,21,40,46,61,221.2790995,336.9372793,4.864864865,1639.154332,91.06412955,0.112312426,0
79,55,70,2,1,0,8,6,24,15,28,30,43,125.548875,210.9962956,3.5,738.4870346,41.02705748,0.070332099,0
22,11,15,4,4,0,3,1,2,1,2,3,3,2,4.754887502,0.5,2.377443751,0.132080208,0.001584963,0
31,19,23,2,2,0,6,3,10,5,10,13,15,37.97416845,55.50659577,1.5,83.25989366,4.625549648,0.018502199,0
260,165,194,15,15,15,36,11,83,61,111,94,172,567.1820206,1127.389282,7.355421687,8292.423578,460.6901988,0.375796427,0
96,73,72,10,13,0,11,1,3,3,3,4,6,4.754887502,12,0.5,6,0.333333333,0.004,0
108,76,78,12,12,7,11,8,34,20,39,42,59,196.9737366,318.1467279,4.588235294,1459.732046,81.09622477,0.106048909,0
49,27,34,8,8,0,7,2,7,4,8,9,12,21.65148445,38.03910002,1.142857143,43.47325716,2.415180953,0.0126797,0
18,13,15,0,0,0,3,1,2,1,2,3,3,2,4.754887502,0.5,2.377443751,0.132080208,0.001584963,0
142,89,116,10,10,0,16,7,31,24,46,38,70,173.2315701,367.3549259,5.193548387,1907.875583,105.993088,0.122451642,0
21,13,17,1,1,0,3,1,2,1,2,3,3,2,4.754887502,0.5,2.377443751,0.132080208,0.001584963,0
41,17,30,5,5,0,6,2,3,2,3,5,5,6.754887502,11.60964047,1,11.60964047,0.644980026,0.00386988,0
8,6,6,0,0,0,2,1,4,2,4,5,6,8,13.93156857,0.5,6.965784285,0.386988016,0.004643856,0
62,42,35,8,13,5,9,6,13,7,13,19,20,63.61549134,84.95855027,3,254.8756508,14.15975838,0.028319517,0
53,33,36,2,2,6,9,3,7,4,7,10,11,24.40637196,36.54120904,1.5,54.81181357,3.045100754,0.012180403,0
42,12,11,2,2,20,9,1,2,1,2,3,3,2,4.754887502,0.5,2.377443751,0.132080208,0.001584963,0
117,55,66,10,10,24,17,9,45,25,47,54,72,275.6627143,414.3519002,4.7,1947.453931,108.191885,0.1381173,0
39,24,23,5,5,5,6,4,8,5,8,12,13,32,46.60451251,2,93.20902502,5.178279168,0.015534838,0
37,25,30,0,0,0,7,6,23,13,26,29,39,119.5517,189.4612588,3.391304348,642.5207907,35.69559949,0.063153753,0
25,18,18,1,1,0,6,1,1,1,1,2,2,0,2,0.5,1,0.055555556,0.000666667,0
46,34,35,1,1,3,7,5,15,8,16,20,24,70.21299941,103.7262743,2.666666667,276.6033981,15.36685545,0.034575425,0
121,99,99,8,8,0,14,11,49,43,71,60,114,313.1745302,673.3855279,7.969387755,5366.470381,298.1372434,0.224461843,0
22,11,19,0,0,0,3,2,4,2,4,6,6,10,15.509775,1,15.509775,0.861654167,0.005169925,0
11,9,9,0,0,0,2,1,2,1,2,3,3,2,4.754887502,0.5,2.377443751,0.132080208,0.001584963,0
13,8,7,0,0,5,1,2,3,2,3,5,5,6.754887502,11.60964047,1,11.60964047,0.644980026,0.00386988,0
14,9,8,0,0,3,3,1,2,1,2,3,3,2,4.754887502,0.5,2.377443751,0.132080208,0.001584963,0
132,64,57,14,13,47,15,6,24,14,26,30,40,125.548875,196.2756238,3.25,637.8957774,35.4386543,0.065425208,0
56,31,24,0,0,23,9,2,4,2,4,6,6,10,15.509775,1,15.509775,0.861654167,0.005169925,0
100,59,59,6,6,22,13,5,23,13,26,28,39,115.6515655,187.486842,2.826086957,529.8541186,29.43633992,0.062495614,0
25,18,18,2,1,0,6,1,2,1,2,3,3,2,4.754887502,0.5,2.377443751,0.132080208,0.001584963,0
7,5,5,0,0,0,2,2,6,4,6,8,10,17.509775,30,1,30,1.666666667,0.01,0
21,12,11,0,0,4,6,3,7,4,8,10,12,24.40637196,39.86313714,1.714285714,68.33680652,3.796489251,0.013287712,0
13,9,9,0,0,0,4,1,2,2,2,3,4,2,6.339850003,0.5,3.169925001,0.176106945,0.002113283,0
17,15,15,0,0,0,2,3,6,3,6,9,9,20.26466251,28.52932501,1.5,42.79398752,2.377443751,0.009509775,0
25,16,18,1,1,0,6,1,1,1,1,2,2,0,2,0.5,1,0.055555556,0.000666667,0
47,31,29,0,0,7,11,4,9,5,10,13,15,36.52932501,55.50659577,2.222222222,123.3479906,6.852666145,0.018502199,0
